season,team_1,team_2,home,seed_diff,score_diff,score_1,score_2,won,pred
1985,288,73,0,-3,-9,41,50,0,-3.601452
1985,5929,73,0,4,6,61,55,1,0.474164
1985,9884,73,0,5,-4,59,63,0,-0.414316
1985,73,288,0,3,9,50,41,1,3.601452
1985,3920,410,0,1,-9,54,63,0,8.176179
1985,8405,410,0,8,3,68,65,1,8.228652
1985,4149,513,0,8,-2,64,66,0,0.824334
1985,6281,513,0,9,6,62,56,1,4.695697
1985,7201,513,0,5,-1,58,59,0,2.819751
1985,2340,764,0,8,-1,73,74,0,8.649769
1985,5077,764,0,9,2,59,57,1,5.473691
1985,8984,764,0,5,-2,53,55,0,0.003181
1985,10020,2082,0,1,2,51,49,1,0.81737
1985,8662,2204,0,3,5,70,65,1,-0.052106
1985,764,2340,0,-8,1,74,73,1,-8.649769
1985,6966,2340,0,-11,-13,62,75,0,-15.456944
1985,5212,2675,0,15,4,59,55,1,25.653147
1985,3234,3132,0,-1,-6,54,60,0,-4.038165
1985,4400,3132,0,-15,-25,43,68,0,-32.865038
1985,4698,3132,0,-3,-12,53,65,0,-10.070142
1985,8405,3132,0,0,-18,59,77,0,-2.775337
1985,8746,3132,0,-7,-17,46,63,0,-13.062736
1985,10020,3132,0,-7,2,66,64,1,-10.324139
1985,3745,3166,0,3,16,74,58,1,2.734931
1985,10564,3166,0,-5,-8,59,67,0,-6.958953
1985,3132,3234,0,1,6,60,54,1,4.038165
1985,3745,3234,0,-1,-8,53,61,0,2.731404
1985,5111,3234,0,-13,-7,58,65,0,-16.431005
1985,8662,3234,0,-5,-17,53,70,0,-4.229987
1985,3166,3745,0,-3,-16,58,74,0,-2.734931
1985,3234,3745,0,1,8,61,53,1,-2.731404
1985,6372,3745,0,-11,-19,57,76,0,-16.574684
1985,6664,3779,0,8,6,75,69,1,10.323451
1985,9663,3779,0,1,-3,55,58,0,0.04784
1985,4698,3886,0,9,1,59,58,1,7.489743
1985,410,3920,0,-1,9,63,54,1,-8.176179
1985,6629,3954,0,9,11,75,64,1,3.640635
1985,513,4149,0,-8,2,66,64,1,-0.824334
1985,6595,4149,0,-11,-11,38,49,0,-6.969901
1985,8405,4264,0,11,16,86,70,1,5.673486
1985,9629,4264,0,8,-3,61,64,0,-2.3338
1985,10366,4264,0,7,-8,58,66,0,0.167065
1985,3132,4400,0,15,25,68,43,1,32.865038
1985,6629,4562,0,1,-12,67,79,0,3.420297
1985,6664,4562,0,4,2,86,84,1,9.261292
1985,7000,4562,0,-7,-24,54,78,0,-2.204847
1985,3132,4698,0,3,12,65,53,1,10.070142
1985,3886,4698,0,-9,-1,58,59,0,-7.489743
1985,8059,4698,0,-1,-13,57,70,0,1.516668
1985,5850,4732,0,-9,23,78,55,1,-7.511886
1985,9884,4907,0,13,16,81,65,1,12.36429
1985,5178,4941,0,-7,-1,68,69,0,-7.840573
1985,5850,4941,0,-8,-5,59,64,0,-8.699646
1985,10020,4941,0,-3,3,46,43,1,-4.429564
1985,764,5077,0,-9,-2,57,59,0,-5.473691
1985,6664,5077,0,1,-2,61,63,0,3.207455
1985,6898,5077,0,-13,-12,55,67,0,-19.859617
1985,9269,5077,0,-5,-1,66,67,0,-6.795742
1985,10020,5077,0,-6,7,52,45,1,-5.703748
1985,3234,5111,0,13,7,65,58,1,16.431005
1985,4941,5178,0,7,1,69,68,1,7.840573
1985,2675,5212,0,-15,-4,55,59,0,-25.653147
1985,10020,5212,0,-7,4,59,55,1,-9.956243
1985,9269,5246,0,3,2,70,68,1,-5.304193
1985,6281,5715,0,13,19,76,57,1,18.297986
1985,4732,5850,0,9,-23,55,78,0,7.511886
1985,4941,5850,0,8,5,64,59,1,8.699646
1985,6664,5884,0,15,13,96,83,1,25.817776
1985,73,5929,0,-4,-6,55,61,0,-0.474164
1985,6012,5929,0,-11,-9,56,65,0,-11.337393
1985,8405,5929,0,2,9,69,60,1,2.415384
1985,9847,5929,0,-8,-13,73,86,0,-7.004179
1985,5929,6012,0,11,9,65,56,1,11.337393
1985,513,6281,0,-9,-6,56,62,0,-4.695697
1985,5715,6281,0,-13,-19,57,76,0,-18.297986
1985,6542,6281,0,-5,-2,58,60,0,-5.491488
1985,10020,6281,0,-6,12,56,44,1,-6.015619
1985,3745,6372,0,11,19,76,57,1,16.574684
1985,6281,6542,0,5,2,60,58,1,5.491488
1985,6830,6542,0,-3,-9,70,79,0,-2.059204
1985,4149,6595,0,11,11,49,38,1,6.969901
1985,3954,6629,0,-9,-11,64,75,0,-3.640635
1985,4562,6629,0,-1,12,79,67,1,-3.420297
1985,3779,6664,0,-8,-6,69,75,0,-10.323451
1985,4562,6664,0,-4,-2,84,86,0,-9.261292
1985,5077,6664,0,-1,2,63,61,1,-3.207455
1985,5884,6664,0,-15,-13,83,96,0,-25.817776
1985,8059,6732,0,7,17,85,68,1,3.993006
1985,6542,6830,0,3,9,79,70,1,2.059204
1985,5077,6898,0,13,12,67,55,1,19.859617
1985,2340,6966,0,11,13,75,62,1,15.456944
1985,4562,7000,0,7,24,78,54,1,2.204847
1985,513,7201,0,-5,1,59,58,1,-2.819751
1985,9629,7693,0,9,5,85,80,1,2.410782
1985,4698,8059,0,1,13,70,57,1,-1.516668
1985,6732,8059,0,-7,-17,68,85,0,-3.993006
1985,8405,8239,0,15,24,83,59,1,16.855071
1985,410,8405,0,-8,-3,65,68,0,-8.228652
1985,3132,8405,0,0,18,77,59,1,2.775337
1985,4264,8405,0,-11,-16,70,86,0,-5.673486
1985,5929,8405,0,-2,-9,60,69,0,-2.415384
1985,8239,8405,0,-15,-24,59,83,0,-16.855071
1985,2204,8662,0,-3,-5,65,70,0,0.052106
1985,3234,8662,0,5,17,70,53,1,4.229987
1985,3132,8746,0,7,17,63,46,1,13.062736
1985,10088,8746,0,-1,-3,57,60,0,7.082052
1985,764,8984,0,-5,2,55,53,1,-0.003181
1985,9847,9167,0,-5,4,79,75,1,-3.509202
1985,5077,9269,0,5,1,67,66,1,6.795742
1985,5246,9269,0,-3,-2,68,70,0,5.304193
1985,4264,9629,0,-8,3,64,61,1,2.3338
1985,7693,9629,0,-9,-5,80,85,0,-2.410782
1985,3779,9663,0,-1,3,58,55,1,-0.04784
1985,5929,9847,0,8,13,86,73,1,7.004179
1985,9167,9847,0,5,-4,75,79,0,3.509202
1985,73,9884,0,-5,4,63,59,1,0.414316
1985,4907,9884,0,-13,-16,65,81,0,-12.36429
1985,2082,10020,0,-1,-2,49,51,0,-0.81737
1985,3132,10020,0,7,-2,64,66,0,10.324139
1985,4941,10020,0,3,-3,43,46,0,4.429564
1985,5077,10020,0,6,-7,45,52,0,5.703748
1985,5212,10020,0,7,-4,55,59,0,9.956243
1985,6281,10020,0,6,-12,44,56,0,6.015619
1985,8746,10088,0,1,3,60,57,1,-7.082052
1985,4264,10366,0,-7,8,66,58,1,-0.167065
1985,3166,10564,0,5,8,67,59,1,6.958953
1986,5213,40,0,13,6,70,64,1,23.802879
1986,3746,74,0,1,-2,56,58,0,4.786426
1986,4265,74,0,4,5,68,63,1,5.873775
1986,10787,74,0,-7,-17,80,97,0,-7.264537
1986,514,289,0,1,10,73,63,1,3.810057
1986,5930,357,0,8,14,80,66,1,17.018486
1986,6543,357,0,11,-7,83,90,0,18.366654
1986,289,514,0,-1,-10,63,73,0,-3.810057
1986,4597,514,0,6,8,84,76,1,6.074496
1986,8406,514,0,7,-16,65,81,0,4.336848
1986,9630,514,0,4,-7,63,70,0,0.539847
1986,5078,589,0,11,32,95,63,1,18.714734
1986,4597,867,0,5,14,82,68,1,10.145854
1986,9848,867,0,-3,-18,65,83,0,-1.779581
1986,8663,909,0,13,49,101,52,1,28.979759
1986,3819,1551,0,11,-4,79,83,0,6.254927
1986,5851,1551,0,7,1,71,70,1,-0.242273
1986,8440,1551,0,8,-6,69,75,0,-5.319121
1986,4265,2049,0,15,20,75,55,1,21.611013
1986,2341,2205,0,11,7,74,67,1,12.390629
1986,6665,2205,0,8,-5,69,74,0,8.580514
1986,10055,2205,0,7,-4,68,72,0,5.457
1986,4597,2307,0,13,20,93,73,1,27.736386
1986,2205,2341,0,-11,-7,67,74,0,-12.390629
1986,4150,2341,0,0,-4,67,71,0,0.599356
1986,4597,2341,0,-1,3,72,69,1,-2.625987
1986,5652,2341,0,-15,-7,78,85,0,-29.071486
1986,5851,2341,0,-6,-21,50,71,0,-9.68747
1986,6733,2341,0,-7,-28,61,89,0,-12.196324
1986,3746,2710,0,9,24,75,51,1,24.445944
1986,5247,3133,0,-1,12,80,68,1,1.998905
1986,8985,3133,0,-9,-6,64,70,0,-14.594543
1986,4733,3235,0,-9,6,70,64,1,-9.329669
1986,4840,3235,0,-13,-15,53,68,0,-31.307733
1986,10021,3235,0,-8,-5,61,66,0,-14.288034
1986,74,3746,0,-1,2,58,56,1,-4.786426
1986,2710,3746,0,-9,-24,51,75,0,-24.445944
1986,1551,3819,0,-11,4,83,79,1,-6.254927
1986,5930,3921,0,5,2,66,64,1,1.018772
1986,5179,3955,0,-3,-2,79,81,0,-7.210018
1986,5213,3955,0,5,-3,69,72,0,8.588507
1986,5930,3955,0,1,4,70,66,1,2.802964
1986,8747,4059,0,-1,11,61,50,1,-1.543323
1986,2341,4150,0,0,4,71,67,1,-0.599356
1986,5247,4150,0,-4,-10,86,96,0,-2.756724
1986,5885,4150,0,-15,-25,46,71,0,-31.165149
1986,5930,4150,0,-5,-8,67,75,0,-5.76172
1986,8747,4150,0,-8,-22,43,65,0,-13.671392
1986,74,4265,0,-4,-5,63,68,0,-5.873775
1986,2049,4265,0,-15,-20,55,75,0,-21.611013
1986,4733,4265,0,-10,2,59,57,1,-7.999633
1986,10225,4265,0,-7,-7,64,71,0,-11.323427
1986,514,4597,0,-6,-8,76,84,0,-6.074496
1986,867,4597,0,-5,-14,68,82,0,-10.145854
1986,2307,4597,0,-13,-20,73,93,0,-27.736386
1986,2341,4597,0,1,-3,69,72,0,2.625987
1986,4733,4597,0,-9,-11,77,88,0,-5.846143
1986,6282,4597,0,-1,-15,79,94,0,7.511272
1986,3235,4733,0,9,-6,64,70,0,9.329669
1986,4265,4733,0,10,-2,57,59,0,7.999633
1986,4597,4733,0,9,11,88,77,1,5.846143
1986,5078,4733,0,8,-2,81,83,0,5.334295
1986,7202,4733,0,5,-7,87,94,0,2.337299
1986,3235,4840,0,13,15,68,53,1,31.307733
1986,6967,4942,0,-7,-5,64,69,0,-7.291085
1986,9630,4942,0,1,6,70,64,1,-1.470094
1986,589,5078,0,-11,-32,63,95,0,-18.714734
1986,4733,5078,0,-8,2,83,81,1,-5.334295
1986,3955,5179,0,3,2,81,79,1,7.210018
1986,40,5213,0,-13,-6,64,70,0,-23.802879
1986,3955,5213,0,-5,3,72,69,1,-8.588507
1986,3133,5247,0,1,-12,68,80,0,-1.998905
1986,4150,5247,0,4,10,96,86,1,2.756724
1986,10367,5247,0,-7,-2,70,72,0,-12.133275
1986,9270,5383,0,5,2,66,64,1,1.02521
1986,8406,5548,0,15,9,83,74,1,17.476935
1986,2341,5652,0,15,7,85,78,1,29.071486
1986,1551,5851,0,-7,-1,70,71,0,0.242273
1986,2341,5851,0,6,21,71,50,1,9.68747
1986,8663,5851,0,5,-12,85,97,0,9.296217
1986,9168,5851,0,-3,-19,68,87,0,-1.933236
1986,4150,5885,0,15,25,71,46,1,31.165149
1986,357,5930,0,-8,-14,66,80,0,-17.018486
1986,3921,5930,0,-5,-2,64,66,0,-1.018772
1986,3955,5930,0,-1,-4,66,70,0,-2.802964
1986,4150,5930,0,5,8,75,67,1,5.76172
1986,10225,5979,0,1,8,67,59,1,-1.220119
1986,4597,6282,0,1,15,94,79,1,-7.511272
1986,9270,6282,0,-3,-18,59,77,0,-13.583555
1986,9766,6282,0,-11,-12,72,84,0,-23.510561
1986,6665,6373,0,9,6,80,74,1,15.200898
1986,357,6543,0,-11,7,90,83,1,-18.366654
1986,2205,6665,0,-8,5,74,69,1,-8.580514
1986,6373,6665,0,-9,-6,74,80,0,-15.200898
1986,2341,6733,0,7,28,89,61,1,12.196324
1986,10469,6733,0,-1,-8,64,72,0,-2.443261
1986,4942,6967,0,7,5,69,64,1,7.291085
1986,4733,7202,0,-5,7,94,87,1,-2.337299
1986,8440,7358,0,5,1,60,59,1,-0.537674
1986,514,8406,0,-7,16,81,65,1,-4.336848
1986,5548,8406,0,-15,-9,74,83,0,-17.476935
1986,1551,8440,0,-8,6,75,69,1,5.319121
1986,7358,8440,0,-5,-1,59,60,0,0.537674
1986,909,8663,0,-13,-49,52,101,0,-28.979759
1986,5851,8663,0,-5,12,97,85,1,-9.296217
1986,4059,8747,0,1,-11,50,61,0,1.543323
1986,4150,8747,0,8,22,65,43,1,13.671392
1986,3133,8985,0,9,6,70,64,1,14.594543
1986,5851,9168,0,3,19,87,68,1,1.933236
1986,5383,9270,0,-5,-2,64,66,0,-1.02521
1986,6282,9270,0,3,18,77,59,1,13.583555
1986,9630,9471,0,9,23,74,51,1,9.0578
1986,514,9630,0,-4,7,70,63,1,-0.539847
1986,4942,9630,0,-1,-6,64,70,0,1.470094
1986,9471,9630,0,-9,-23,51,74,0,-9.0578
1986,6282,9766,0,11,12,84,72,1,23.510561
1986,867,9848,0,3,18,83,65,1,1.779581
1986,3235,10021,0,8,5,66,61,1,14.288034
1986,10089,10021,0,3,-9,62,71,0,2.675896
1986,2205,10055,0,-7,4,72,68,1,-5.457
1986,10021,10089,0,-3,9,71,62,1,-2.675896
1986,4265,10225,0,7,7,71,64,1,11.323427
1986,5979,10225,0,-1,-8,59,67,0,1.220119
1986,5247,10367,0,7,2,72,70,1,12.133275
1986,6733,10469,0,1,8,72,64,1,2.443261
1986,74,10787,0,7,17,97,80,1,7.264537
1987,5886,75,0,-13,-17,71,88,0,-20.783956
1987,6150,75,0,-5,-25,76,101,0,-8.327515
1987,7169,75,0,-4,21,103,82,1,-5.876588
1987,9849,290,0,3,7,98,91,1,-3.959627
1987,3820,515,0,7,17,107,90,1,5.659979
1987,7661,515,0,-1,-1,61,62,0,-6.006384
1987,3747,556,0,11,-1,67,68,0,17.151764
1987,7169,556,0,8,3,90,87,1,12.579056
1987,3134,954,0,15,22,75,53,1,23.534179
1987,6150,1049,0,3,4,83,79,1,2.171131
1987,9404,1083,0,9,19,92,73,1,6.884623
1987,5447,1518,0,-9,5,65,60,1,-8.093263
1987,4564,2206,0,-11,-14,62,76,0,-9.061149
1987,4734,2206,0,-7,5,63,58,1,-5.253876
1987,8407,2206,0,-3,-8,75,83,0,-3.102589
1987,3820,2342,0,4,6,88,82,1,2.316134
1987,8918,2342,0,-7,-7,51,58,0,-12.539338
1987,10788,2342,0,-8,-5,60,65,0,-17.088915
1987,3820,2711,0,15,34,92,58,1,23.983864
1987,5931,2781,0,-5,-12,70,82,0,-8.687478
1987,7203,2781,0,3,-19,66,85,0,-1.206008
1987,8664,2781,0,4,6,87,81,1,-3.227757
1987,8664,3050,0,13,6,79,73,1,22.248813
1987,954,3134,0,-15,-22,53,75,0,-23.534179
1987,4151,3134,0,-4,-13,57,70,0,-3.986377
1987,6631,3134,0,-8,-3,79,82,0,-2.823379
1987,7169,3134,0,-5,15,88,73,1,-3.117067
1987,4185,3168,0,-1,3,82,79,1,-1.112305
1987,4734,3236,0,-3,6,85,79,1,-0.700507
1987,4151,3561,0,7,11,66,55,1,0.883427
1987,9631,3679,0,15,25,95,70,1,24.29986
1987,556,3747,0,-11,1,68,67,1,-17.151764
1987,515,3820,0,-7,-17,90,107,0,-5.659979
1987,2342,3820,0,-4,-6,82,88,0,-2.316134
1987,2711,3820,0,-15,-34,58,92,0,-23.983864
1987,4734,3820,0,-9,-1,76,77,0,-9.088182
1987,8664,3820,0,-1,-1,73,74,0,-3.235039
1987,9631,3820,0,0,-4,93,97,0,3.126168
1987,6666,3922,0,-4,-2,91,93,0,-4.231099
1987,7830,3922,0,-13,-23,76,99,0,-17.613278
1987,9631,3922,0,1,3,84,81,1,2.463484
1987,9849,3922,0,-5,-2,82,84,0,-10.649683
1987,3134,4151,0,4,13,70,57,1,3.986377
1987,3561,4151,0,-7,-11,55,66,0,-0.883427
1987,5447,4151,0,-8,-4,63,67,0,-4.154437
1987,3168,4185,0,1,-3,79,82,0,1.112305
1987,9631,4185,0,8,19,80,61,1,12.739033
1987,6631,4266,0,-1,14,91,77,1,2.606612
1987,2206,4564,0,11,14,76,62,1,9.061149
1987,2206,4734,0,7,-5,58,63,0,5.253876
1987,3236,4734,0,3,-6,79,85,0,0.700507
1987,3820,4734,0,9,1,77,76,1,9.088182
1987,8748,4734,0,8,-10,62,72,0,2.430853
1987,7002,4841,0,11,25,93,68,1,19.791405
1987,8714,4909,0,9,16,76,60,1,9.80587
1987,5852,5214,0,1,-15,82,97,0,-5.551425
1987,6283,5214,0,8,12,109,97,1,10.222691
1987,10788,5384,0,-9,1,70,69,1,-10.75671
1987,1518,5447,0,9,-5,60,65,0,8.093263
1987,4151,5447,0,8,4,67,63,1,4.154437
1987,6544,5717,0,7,13,84,71,1,7.629333
1987,5214,5852,0,-1,15,97,82,1,5.551425
1987,75,5886,0,13,17,88,71,1,20.783956
1987,2781,5931,0,5,12,82,70,1,8.687478
1987,75,6150,0,5,25,101,76,1,8.327515
1987,1049,6150,0,-3,-4,79,83,0,-2.171131
1987,5214,6283,0,-8,-12,97,109,0,-10.222691
1987,6544,6283,0,-4,-6,68,74,0,-13.796157
1987,6900,6283,0,-15,-31,82,113,0,-25.178285
1987,8664,6283,0,-1,4,79,75,1,-8.169713
1987,7203,6374,0,11,9,104,95,1,15.317928
1987,5717,6544,0,-7,-13,71,84,0,-7.629333
1987,6283,6544,0,4,6,74,68,1,13.796157
1987,8714,6544,0,1,-1,57,58,0,1.548999
1987,3134,6631,0,8,3,82,79,1,2.823379
1987,4266,6631,0,1,-14,77,91,0,-2.606612
1987,3922,6666,0,4,2,93,91,1,4.231099
1987,7002,6666,0,3,-3,93,96,0,-0.21956
1987,9169,6666,0,-5,-5,69,74,0,-7.223925
1987,6283,6900,0,15,31,113,82,1,25.178285
1987,4841,7002,0,-11,-25,68,93,0,-19.791405
1987,6666,7002,0,-3,3,96,93,1,0.21956
1987,75,7169,0,4,-21,82,103,0,5.876588
1987,556,7169,0,-8,-3,87,90,0,-12.579056
1987,3134,7169,0,5,-15,73,88,0,3.117067
1987,8664,7169,0,4,14,77,63,1,2.802023
1987,9271,7169,0,-5,-22,68,90,0,-8.897994
1987,2781,7203,0,-3,19,85,66,1,1.206008
1987,6374,7203,0,-11,-9,95,104,0,-15.317928
1987,515,7661,0,1,1,62,61,1,6.006384
1987,3922,7830,0,13,23,99,76,1,17.613278
1987,8748,8241,0,13,19,75,56,1,16.191943
1987,2206,8407,0,3,8,83,75,1,3.102589
1987,10566,8407,0,-5,-2,55,57,0,-6.225706
1987,2781,8664,0,-4,-6,81,87,0,3.227757
1987,3050,8664,0,-13,-6,73,79,0,-22.248813
1987,3820,8664,0,1,1,74,73,1,3.235039
1987,6283,8664,0,1,-4,75,79,0,8.169713
1987,7169,8664,0,-4,-14,63,77,0,-2.802023
1987,10226,8664,0,-8,-18,86,104,0,-3.526832
1987,4909,8714,0,-9,-16,60,76,0,-9.80587
1987,6544,8714,0,-1,1,58,57,1,-1.548999
1987,4734,8748,0,-8,10,72,62,1,-2.430853
1987,8241,8748,0,-13,-19,56,75,0,-16.191943
1987,2342,8918,0,7,7,58,51,1,12.539338
1987,6666,9169,0,5,5,74,69,1,7.223925
1987,7169,9271,0,5,22,90,68,1,8.897994
1987,1083,9404,0,-9,-19,73,92,0,-6.884623
1987,10754,9404,0,-8,10,78,68,1,-6.764246
1987,3679,9631,0,-15,-25,70,95,0,-24.29986
1987,3820,9631,0,0,4,97,93,1,-3.126168
1987,3922,9631,0,-1,-3,81,84,0,-2.463484
1987,4185,9631,0,-8,-19,61,80,0,-12.739033
1987,10754,9631,0,-11,-14,78,92,0,-16.534038
1987,290,9849,0,-3,-7,91,98,0,3.959627
1987,3922,9849,0,5,2,84,82,1,10.649683
1987,10754,10056,0,-7,4,64,60,1,-7.584209
1987,8664,10226,0,8,18,104,86,1,3.526832
1987,10470,10226,0,3,-2,62,64,0,-3.062072
1987,10226,10470,0,-3,2,64,62,1,3.062072
1987,8407,10566,0,5,2,57,55,1,6.225706
1987,9404,10754,0,8,-10,68,78,0,6.764246
1987,9631,10754,0,11,14,92,78,1,16.534038
1987,10056,10754,0,7,-4,60,64,0,7.584209
1987,2342,10788,0,8,5,65,60,1,17.088915
1987,5384,10788,0,9,-1,69,70,0,10.75671
1988,1849,291,0,-15,-40,50,90,0,-33.274847
1988,3923,291,0,-4,-20,79,99,0,-5.923629
1988,6284,291,0,-1,-18,52,70,0,-9.159789
1988,6667,291,0,0,8,86,78,1,1.694711
1988,7962,291,0,-7,-29,55,84,0,-13.349345
1988,10023,413,0,5,8,82,74,1,1.713901
1988,869,516,0,-1,-4,86,90,0,-1.474115
1988,6667,516,0,7,20,107,87,1,15.051497
1988,5080,625,0,-1,15,75,60,1,3.341139
1988,5215,733,0,11,5,63,58,1,10.910279
1988,2343,801,0,13,16,85,69,1,24.152516
1988,516,869,0,1,4,90,86,1,1.474115
1988,1349,1050,0,-9,-6,92,98,0,-10.471233
1988,4599,1050,0,-1,21,97,76,1,0.910515
1988,1050,1349,0,9,6,98,92,1,10.471233
1988,6667,1383,0,15,28,94,66,1,31.781282
1988,291,1849,0,15,40,90,50,1,33.274847
1988,4186,2207,0,1,8,66,58,1,4.005703
1988,10567,2207,0,-7,-21,62,83,0,-3.455609
1988,801,2343,0,-13,-16,69,85,0,-24.152516
1988,4152,2343,0,-4,7,66,59,1,-10.233186
1988,7292,2343,0,-9,-1,72,73,0,-16.005832
1988,8062,2343,0,-5,-15,79,94,0,-13.035382
1988,8749,2343,0,1,-10,53,63,0,-6.415183
1988,7003,2479,0,13,18,108,90,1,15.357198
1988,7204,2678,0,15,15,94,79,1,26.937854
1988,5215,2782,0,3,23,108,85,1,7.478616
1988,8408,2782,0,-5,-3,59,62,0,-3.495197
1988,3923,2881,0,7,4,102,98,1,10.580219
1988,4735,3135,0,-1,-3,63,66,0,-3.291695
1988,8749,3135,0,7,21,74,53,1,2.939428
1988,3957,3237,0,-7,-12,78,90,0,-1.093963
1988,7360,3237,0,-8,4,59,55,1,-11.10567
1988,9734,3748,0,-11,-9,72,81,0,-18.848682
1988,10023,3748,0,-3,3,66,63,1,-9.061908
1988,7360,3821,0,-9,3,72,69,1,-15.291874
1988,291,3923,0,4,20,99,79,1,5.923629
1988,2881,3923,0,-7,-4,98,102,0,-10.580219
1988,9632,3923,0,1,-18,86,104,0,-3.898001
1988,3237,3957,0,7,12,90,78,1,1.093963
1988,2343,4152,0,4,-7,59,66,0,10.233186
1988,4186,4152,0,2,-13,58,71,0,1.753567
1988,5752,4152,0,-8,-3,58,61,0,-10.556774
1988,6667,4152,0,5,-4,79,83,0,15.833785
1988,9955,4152,0,-1,-13,64,77,0,0.520233
1988,10789,4152,0,-5,-13,72,85,0,-3.848406
1988,2207,4186,0,-1,-8,58,66,0,-4.005703
1988,4152,4186,0,-2,13,71,58,1,-1.753567
1988,4301,4186,0,-9,-13,53,66,0,-10.098273
1988,7204,4186,0,3,-3,70,73,0,6.586847
1988,4944,4267,0,-5,-9,81,90,0,-8.028794
1988,8242,4267,0,-13,-15,84,99,0,-18.523709
1988,10023,4267,0,-4,6,80,74,1,-6.576106
1988,4186,4301,0,9,13,66,53,1,10.098273
1988,8749,4403,0,15,14,87,73,1,19.629275
1988,1050,4599,0,1,-21,76,97,0,-0.910515
1988,6667,4599,0,4,10,108,98,1,14.572598
1988,6833,4599,0,-7,-9,61,70,0,-4.04929
1988,6284,4633,0,8,26,123,97,1,5.077313
1988,10755,4633,0,3,-4,115,119,0,1.149895
1988,3135,4735,0,1,3,66,63,1,3.291695
1988,4267,4944,0,5,9,90,81,1,8.028794
1988,7797,4944,0,-3,-10,82,92,0,-1.230893
1988,625,5080,0,1,-15,60,75,0,-3.341139
1988,7204,5080,0,8,27,100,73,1,12.15996
1988,733,5215,0,-11,-5,58,63,0,-10.910279
1988,2782,5215,0,-3,-23,85,108,0,-7.478616
1988,6284,5215,0,1,9,78,69,1,-3.854837
1988,7292,5385,0,-5,7,87,80,1,-10.206046
1988,9632,5448,0,9,4,54,50,1,11.040252
1988,4152,5752,0,8,3,61,58,1,10.556774
1988,5932,5752,0,11,-3,75,78,0,14.483452
1988,8665,5887,0,11,14,69,55,1,20.780411
1988,5752,5932,0,-11,3,78,75,1,-14.483452
1988,291,6284,0,1,18,70,52,1,9.159789
1988,4633,6284,0,-8,-26,97,123,0,-5.077313
1988,5215,6284,0,-1,-9,69,78,0,3.854837
1988,6341,6284,0,-13,-18,65,83,0,-17.287695
1988,6284,6341,0,13,18,83,65,1,17.287695
1988,8062,6545,0,3,8,83,75,1,-1.465493
1988,291,6667,0,0,-8,78,86,0,-1.694711
1988,516,6667,0,-7,-20,87,107,0,-15.051497
1988,1383,6667,0,-15,-28,66,94,0,-31.781282
1988,4152,6667,0,-5,4,83,79,1,-15.833785
1988,4599,6667,0,-4,-10,98,108,0,-14.572598
1988,10023,6667,0,-5,-19,59,78,0,-16.480512
1988,4599,6833,0,7,9,70,61,1,4.04929
1988,2479,7003,0,-13,-18,90,108,0,-15.357198
1988,9955,7003,0,-5,6,80,74,1,-2.695333
1988,2678,7204,0,-15,-15,79,94,0,-26.937854
1988,4186,7204,0,-3,3,73,70,1,-6.586847
1988,5080,7204,0,-8,-27,73,100,0,-12.15996
1988,2343,7292,0,9,1,73,72,1,16.005832
1988,5385,7292,0,5,-7,80,87,0,10.206046
1988,8665,7292,0,8,-3,94,97,0,15.116548
1988,3237,7360,0,8,-4,55,59,0,11.10567
1988,3821,7360,0,9,-3,69,72,0,15.291874
1988,8749,7360,0,12,22,69,47,1,14.698137
1988,4944,7797,0,3,10,92,82,1,1.230893
1988,291,7962,0,7,29,84,55,1,13.349345
1988,9850,7962,0,-1,-16,64,80,0,-4.052266
1988,2343,8062,0,5,15,94,79,1,13.035382
1988,6545,8062,0,-3,-8,75,83,0,1.465493
1988,4267,8242,0,13,15,99,84,1,18.523709
1988,2782,8408,0,5,3,62,59,1,3.495197
1988,5887,8665,0,-11,-14,55,69,0,-20.780411
1988,7292,8665,0,-8,3,97,94,1,-15.116548
1988,2343,8749,0,-1,10,63,53,1,6.415183
1988,3135,8749,0,-7,-21,53,74,0,-2.939428
1988,4403,8749,0,-15,-14,73,87,0,-19.629275
1988,7360,8749,0,-12,-22,47,69,0,-14.698137
1988,3923,9632,0,-1,18,104,86,1,3.898001
1988,5448,9632,0,-9,-4,50,54,0,-11.040252
1988,3748,9734,0,11,9,81,72,1,18.848682
1988,9955,9802,0,3,3,80,77,1,2.492525
1988,7962,9850,0,1,16,80,64,1,4.052266
1988,4152,9955,0,1,13,77,64,1,-0.520233
1988,7003,9955,0,5,-6,74,80,0,2.695333
1988,9802,9955,0,-3,-3,77,80,0,-2.492525
1988,413,10023,0,-5,-8,74,82,0,-1.713901
1988,3748,10023,0,3,-3,63,66,0,9.061908
1988,4267,10023,0,4,-6,74,80,0,6.576106
1988,6667,10023,0,5,19,78,59,1,16.480512
1988,2207,10567,0,7,21,83,62,1,3.455609
1988,4633,10755,0,-3,4,119,115,1,-1.149895
1988,4152,10789,0,5,13,85,72,1,3.848406
1989,8097,77,0,-5,2,86,84,1,3.395341
1989,1520,292,0,-8,-26,68,94,0,-16.869252
1989,7429,292,0,-15,-34,60,94,0,-37.375623
1989,9633,292,0,-3,1,68,67,1,-10.646766
1989,4600,360,0,9,5,76,71,1,7.979328
1989,4600,414,0,1,9,93,84,1,0.524036
1989,4634,414,0,-7,-19,101,120,0,-9.368079
1989,3749,592,0,8,12,72,60,1,16.430445
1989,7004,592,0,1,-4,64,68,0,2.246535
1989,8666,956,0,13,23,104,81,1,25.629678
1989,292,1520,0,8,26,94,68,1,16.869252
1989,8511,1520,0,1,-13,70,83,0,5.236055
1989,2783,1715,0,3,-22,46,68,0,1.019504
1989,8666,1715,0,8,15,65,50,1,15.068382
1989,5386,1884,0,11,16,85,69,1,17.335943
1989,5081,2208,0,7,-3,63,66,0,3.106921
1989,9633,2208,0,8,15,85,70,1,8.297543
1989,3136,2344,0,1,-8,77,85,0,-4.983842
1989,5284,2344,0,-9,-17,70,87,0,-12.219904
1989,7497,2344,0,-13,-21,69,90,0,-30.777676
1989,7963,2344,0,-1,17,95,78,1,-7.09788
1989,10472,2344,0,-5,-7,63,70,0,-15.709299
1989,6668,2611,0,15,1,72,71,1,26.122838
1989,6834,2645,0,5,-4,90,94,0,4.928363
1989,7963,2645,0,8,14,87,73,1,6.970024
1989,1715,2783,0,-3,22,68,46,1,-1.019504
1989,5719,2882,0,-9,14,97,83,1,-11.413642
1989,3822,3102,0,13,14,99,85,1,24.228926
1989,2344,3136,0,-1,8,85,77,1,4.983842
1989,5933,3136,0,-4,-8,61,69,0,-3.365021
1989,6546,3136,0,-8,-7,74,81,0,-10.23743
1989,7137,3136,0,-15,-1,49,50,0,-24.246769
1989,8886,3238,0,-5,6,76,70,1,-4.944978
1989,9633,3647,0,9,12,68,56,1,6.680648
1989,592,3749,0,-8,-12,60,72,0,-16.430445
1989,4600,3749,0,-3,-14,69,83,0,-7.723776
1989,5013,3749,0,-15,-6,71,77,0,-28.67727
1989,5216,3749,0,-2,2,83,81,1,2.568402
1989,8666,3749,0,-1,-3,86,89,0,-3.601329
1989,3102,3822,0,-13,-14,85,99,0,-24.228926
1989,7963,3822,0,-1,13,78,65,1,-1.976382
1989,9851,3822,0,-5,-23,69,92,0,-7.408234
1989,5933,3924,0,-1,6,102,96,1,-2.027967
1989,7463,3924,0,-9,-14,73,87,0,-17.467441
1989,9406,3958,0,3,10,84,74,1,3.291805
1989,5284,4187,0,-5,11,86,75,1,-0.60767
1989,4566,4302,0,-1,9,83,74,1,-3.460688
1989,4302,4566,0,1,-9,74,83,0,3.460688
1989,6668,4566,0,8,43,124,81,1,16.858158
1989,360,4600,0,-9,-5,71,76,0,-7.979328
1989,414,4600,0,-1,-9,84,93,0,-0.524036
1989,3749,4600,0,3,14,83,69,1,7.723776
1989,414,4634,0,7,19,120,101,1,9.368079
1989,9851,4736,0,3,11,85,74,1,4.594073
1989,3749,5013,0,15,6,77,71,1,28.67727
1989,2208,5081,0,-7,3,66,63,1,-3.106921
1989,3749,5216,0,2,-2,81,83,0,-2.568402
1989,6285,5216,0,1,-5,87,92,0,-4.879491
1989,7963,5216,0,0,-1,79,80,0,-9.354814
1989,8097,5216,0,-8,-9,82,91,0,-14.830994
1989,10058,5216,0,-2,-37,65,102,0,-12.665868
1989,10790,5216,0,-11,-5,87,92,0,-23.173968
1989,2344,5284,0,9,17,87,70,1,12.219904
1989,4187,5284,0,5,-11,75,86,0,0.60767
1989,8029,5284,0,-3,-13,67,80,0,-5.280633
1989,1884,5386,0,-11,-16,69,85,0,-17.335943
1989,8666,5386,0,1,3,83,80,1,1.081782
1989,8886,5386,0,-8,-19,89,108,0,-11.174241
1989,7963,5449,0,11,9,60,51,1,13.082644
1989,2882,5719,0,9,-14,83,97,0,11.413642
1989,10058,5719,0,8,16,104,88,1,10.808066
1989,3136,5933,0,4,8,69,61,1,3.365021
1989,3924,5933,0,1,-6,96,102,0,2.027967
1989,8131,5933,0,-7,-15,66,81,0,-9.420857
1989,5216,6285,0,-1,5,92,87,1,4.879491
1989,8243,6285,0,-13,-14,79,93,0,-24.194359
1989,9406,6285,0,-5,-7,81,88,0,-9.458437
1989,3136,6546,0,8,7,81,74,1,10.23743
1989,9956,6546,0,1,-16,65,81,0,2.088739
1989,2611,6668,0,-15,-1,71,72,0,-26.122838
1989,4566,6668,0,-8,-43,81,124,0,-16.858158
1989,10058,6668,0,-4,6,86,80,1,-9.045131
1989,2645,6834,0,-5,4,94,90,1,-4.928363
1989,592,7004,0,-1,4,68,64,1,-2.246535
1989,3136,7137,0,15,1,50,49,1,24.246769
1989,10058,7171,0,7,3,100,97,1,-0.510098
1989,292,7429,0,15,34,94,60,1,37.375623
1989,3924,7463,0,9,14,87,73,1,17.467441
1989,2344,7497,0,13,21,90,69,1,30.777676
1989,2344,7963,0,1,-17,78,95,0,7.09788
1989,2645,7963,0,-8,-14,73,87,0,-6.970024
1989,3822,7963,0,1,-13,65,78,0,1.976382
1989,5216,7963,0,0,1,80,79,1,9.354814
1989,5449,7963,0,-11,-9,51,60,0,-13.082644
1989,9633,7963,0,-1,-23,61,84,0,-1.15585
1989,5284,8029,0,3,13,80,67,1,5.280633
1989,8579,8029,0,11,-2,78,80,0,12.24805
1989,77,8097,0,5,-2,84,86,0,-3.395341
1989,5216,8097,0,8,9,91,82,1,14.830994
1989,5933,8131,0,7,15,81,66,1,9.420857
1989,6285,8243,0,13,14,93,79,1,24.194359
1989,1520,8511,0,-1,13,83,70,1,-5.236055
1989,8029,8579,0,-11,2,80,78,1,-12.24805
1989,956,8666,0,-13,-23,81,104,0,-25.629678
1989,1715,8666,0,-8,-15,50,65,0,-15.068382
1989,3749,8666,0,1,3,89,86,1,3.601329
1989,5386,8666,0,-1,-3,80,83,0,-1.081782
1989,10472,8784,0,3,16,84,68,1,0.08109
1989,3238,8886,0,5,-6,70,76,0,4.944978
1989,5386,8886,0,8,19,108,89,1,11.174241
1989,3958,9406,0,-3,-10,74,84,0,-3.291805
1989,6285,9406,0,5,7,88,81,1,9.458437
1989,292,9633,0,3,-1,67,68,0,10.646766
1989,2208,9633,0,-8,-15,70,85,0,-8.297543
1989,3647,9633,0,-9,-12,56,68,0,-6.680648
1989,7963,9633,0,1,23,84,61,1,1.15585
1989,3822,9851,0,5,23,92,69,1,7.408234
1989,4736,9851,0,-3,-11,74,85,0,-4.594073
1989,6546,9956,0,-1,16,81,65,1,-2.088739
1989,5216,10058,0,2,37,102,65,1,12.665868
1989,5719,10058,0,-8,-16,88,104,0,-10.808066
1989,6668,10058,0,4,-6,80,86,0,9.045131
1989,7171,10058,0,-7,-3,97,100,0,0.510098
1989,2344,10472,0,5,7,70,63,1,15.709299
1989,8784,10472,0,-3,-16,68,84,0,-0.08109
1989,5216,10790,0,11,5,92,87,1,23.173968
1990,293,78,0,5,-22,55,77,0,8.252302
1990,1716,78,0,-3,-17,54,71,0,-3.448
1990,4635,78,0,-4,2,62,60,1,0.708087
1990,78,293,0,-5,22,77,55,1,-8.252302
1990,8176,293,0,-13,-12,67,79,0,-21.338885
1990,9634,361,0,15,30,102,72,1,22.530815
1990,2087,415,0,-8,-2,84,86,0,-11.279802
1990,2345,415,0,1,14,97,83,1,1.313329
1990,6286,415,0,-4,-23,73,96,0,-4.785172
1990,7138,415,0,-9,-4,64,68,0,-16.001563
1990,8887,415,0,-6,-3,85,88,0,-8.130063
1990,4601,593,0,8,-2,60,62,0,5.709554
1990,6835,593,0,7,-1,53,54,0,2.74123
1990,9634,593,0,11,2,69,67,1,11.567118
1990,1784,803,0,15,24,76,52,1,19.178902
1990,1521,1052,0,7,2,49,47,1,6.205812
1990,1784,1144,0,8,20,74,54,1,6.271725
1990,3823,1144,0,1,-2,63,65,0,8.170581
1990,1052,1521,0,-7,-2,47,49,0,-6.205812
1990,1784,1521,0,4,1,71,70,1,2.180245
1990,4303,1521,0,1,-4,75,79,0,-2.631713
1990,78,1716,0,3,17,71,54,1,3.448
1990,803,1784,0,-15,-24,52,76,0,-19.178902
1990,1144,1784,0,-8,-20,54,74,0,-6.271725
1990,1521,1784,0,-4,-1,70,71,0,-2.180245
1990,2345,1784,0,-2,1,79,78,1,3.871226
1990,8667,1817,0,13,22,70,48,1,21.599678
1990,415,2087,0,8,2,86,84,1,11.279802
1990,3750,2087,0,7,-2,86,88,0,10.544815
1990,415,2345,0,-1,-14,83,97,0,-1.313329
1990,1784,2345,0,2,-1,78,79,0,-3.871226
1990,7362,2345,0,-11,-35,46,81,0,-20.199044
1990,8410,2345,0,-3,-4,72,76,0,-9.352934
1990,9407,2345,0,-4,-9,81,90,0,-8.578701
1990,9634,2345,0,2,30,103,73,1,1.461566
1990,3239,2612,0,9,16,99,83,1,11.852497
1990,9240,3137,0,-11,-18,52,70,0,-21.265837
1990,10791,3137,0,-3,3,74,71,1,-8.673394
1990,8887,3171,0,-3,12,100,88,1,0.468138
1990,2612,3239,0,-9,-16,83,99,0,-11.852497
1990,4737,3239,0,-1,-3,91,94,0,-1.699574
1990,5251,3239,0,3,-1,80,81,0,-0.009572
1990,5285,3239,0,-2,-2,91,93,0,1.661827
1990,9634,3239,0,3,9,90,81,1,5.30654
1990,7799,3564,0,-1,4,70,66,1,1.923424
1990,4601,3648,0,9,19,78,59,1,9.884509
1990,2087,3750,0,-7,2,88,86,1,-10.544815
1990,5217,3784,0,11,6,76,70,1,16.333462
1990,1144,3823,0,-1,2,65,63,1,-8.170581
1990,7430,4154,0,-13,-8,71,79,0,-27.690824
1990,9407,4154,0,-5,1,71,70,1,-13.906331
1990,10791,4188,0,5,8,87,79,1,-0.219538
1990,1521,4303,0,-1,4,79,75,1,2.631713
1990,8210,4303,0,-9,-16,63,79,0,-6.926937
1990,593,4601,0,-8,2,62,60,1,-5.709554
1990,3648,4601,0,-9,-19,59,78,0,-9.884509
1990,78,4635,0,4,-2,60,62,0,-0.708087
1990,5217,4635,0,8,-34,115,149,0,5.269858
1990,6119,4635,0,5,-19,92,111,0,-3.327879
1990,9634,4635,0,10,30,131,101,1,7.937312
1990,3239,4737,0,1,3,94,91,1,1.699574
1990,10025,4737,0,-7,-7,63,70,0,-5.638523
1990,3784,5217,0,-11,-6,70,76,0,-16.333462
1990,4635,5217,0,-8,34,149,115,1,-5.269858
1990,3239,5251,0,-3,1,81,80,1,0.009572
1990,5754,5251,0,-15,-4,71,75,0,-20.625191
1990,7799,5251,0,-8,-4,58,62,0,-5.01286
1990,3239,5285,0,2,2,93,91,1,-1.661827
1990,6445,5285,0,-8,-3,78,81,0,-15.9894
1990,8667,5285,0,4,-7,75,82,0,-0.469204
1990,9852,5285,0,-5,-3,61,64,0,-10.12007
1990,6445,5387,0,-11,3,74,71,1,-13.544199
1990,6286,5450,0,1,13,83,70,1,4.36418
1990,5251,5754,0,15,4,75,71,1,20.625191
1990,4635,6119,0,-5,19,111,92,1,3.327879
1990,415,6286,0,4,23,96,73,1,4.785172
1990,5450,6286,0,-1,-13,70,83,0,-4.36418
1990,6669,6286,0,7,-2,77,79,0,12.431137
1990,5285,6445,0,8,3,81,78,1,15.9894
1990,5387,6445,0,11,-3,71,74,0,13.544199
1990,10059,6547,0,3,8,75,67,1,-0.620932
1990,7172,6634,0,-1,-1,83,84,0,-1.094982
1990,9634,6634,0,7,11,76,65,1,8.37229
1990,6286,6669,0,-7,2,79,77,1,-12.431137
1990,9083,6669,0,-15,-9,68,77,0,-33.148314
1990,593,6835,0,-7,1,54,53,1,-2.74123
1990,415,7138,0,9,4,68,64,1,16.001563
1990,6634,7172,0,1,1,84,83,1,1.094982
1990,8887,7206,0,-8,1,73,72,1,-6.528648
1990,9475,7206,0,-13,-12,63,75,0,-15.341113
1990,2345,7362,0,11,35,81,46,1,20.199044
1990,4154,7430,0,13,8,79,71,1,27.690824
1990,3564,7799,0,1,-4,66,70,0,-1.923424
1990,5251,7799,0,8,4,62,58,1,5.01286
1990,293,8176,0,13,12,79,67,1,21.338885
1990,4303,8210,0,9,16,79,63,1,6.926937
1990,2345,8410,0,3,4,76,72,1,9.352934
1990,8751,8410,0,-5,-16,65,81,0,-3.349999
1990,1817,8667,0,-13,-22,48,70,0,-21.599678
1990,5285,8667,0,-4,7,82,75,1,0.469204
1990,10059,8667,0,-5,-2,61,63,0,-7.318352
1990,8410,8751,0,5,16,81,65,1,3.349999
1990,415,8887,0,6,3,88,85,1,8.130063
1990,3171,8887,0,3,-12,88,100,0,-0.468138
1990,7206,8887,0,8,-1,72,73,0,6.528648
1990,10791,8887,0,4,-13,89,102,0,0.929838
1990,6669,9083,0,15,9,77,68,1,33.148314
1990,3137,9240,0,11,18,70,52,1,21.265837
1990,9407,9274,0,3,12,68,56,1,0.009383
1990,2345,9407,0,4,9,90,81,1,8.578701
1990,4154,9407,0,5,-1,70,71,0,13.906331
1990,9274,9407,0,-3,-12,56,68,0,-0.009383
1990,7206,9475,0,13,12,75,63,1,15.341113
1990,361,9634,0,-15,-30,72,102,0,-22.530815
1990,593,9634,0,-11,-2,67,69,0,-11.567118
1990,2345,9634,0,-2,-30,73,103,0,-1.461566
1990,3239,9634,0,-3,-9,81,90,0,-5.30654
1990,4635,9634,0,-10,-30,101,131,0,-7.937312
1990,6634,9634,0,-7,-11,65,76,0,-8.37229
1990,5285,9852,0,5,3,64,61,1,10.12007
1990,4737,10025,0,7,7,70,63,1,5.638523
1990,6547,10059,0,-3,-8,67,75,0,0.620932
1990,8667,10059,0,5,2,63,61,1,7.318352
1990,3137,10791,0,3,-3,71,74,0,8.673394
1990,4188,10791,0,-5,-8,79,87,0,0.219538
1990,8887,10791,0,-4,13,102,89,1,-0.929838
1991,416,79,0,3,23,93,70,1,12.830282
1991,5755,79,0,-9,-10,79,89,0,-9.63798
1991,10338,79,0,-1,-8,88,96,0,-1.264547
1991,1053,294,0,-8,-15,61,76,0,-16.400923
1991,7965,294,0,-1,4,81,77,1,-7.430893
1991,8377,294,0,-13,-13,80,93,0,-23.961721
1991,416,328,0,7,7,97,90,1,13.287326
1991,7465,328,0,-1,-3,76,79,0,-8.195099
1991,79,416,0,-3,-23,70,93,0,-12.830282
1991,328,416,0,-7,-7,90,97,0,-13.287326
1991,3206,416,0,-15,-41,76,117,0,-35.74499
1991,4155,416,0,-2,12,93,81,1,-3.657701
1991,294,1053,0,8,15,76,61,1,16.400923
1991,10060,1053,0,3,-13,48,61,0,7.221099
1991,3824,1588,0,13,10,79,69,1,25.538191
1991,2346,1785,0,9,14,81,67,1,8.410452
1991,4738,1785,0,5,-17,62,79,0,3.713162
1991,10792,1785,0,-3,-16,50,66,0,-11.324775
1991,6120,1886,0,5,-8,56,64,0,1.815875
1991,7965,1886,0,8,12,81,69,1,6.271036
1991,3240,2210,0,1,17,87,70,1,2.001158
1991,1785,2346,0,-9,-14,67,81,0,-8.410452
1991,3926,2346,0,-5,-15,70,85,0,-12.501065
1991,4155,2346,0,-1,-7,65,72,0,0.382562
1991,8411,2346,0,-2,-17,61,78,0,-11.021414
1991,9476,2346,0,-13,-29,73,102,0,-22.505886
1991,9635,2346,0,1,-2,77,79,0,8.214509
1991,5354,2482,0,7,-20,56,76,0,4.725904
1991,6287,2482,0,11,26,93,67,1,17.156866
1991,6938,2482,0,-1,-3,68,71,0,-1.798243
1991,3926,2613,0,3,3,76,73,1,-0.596994
1991,3824,2884,0,5,22,82,60,1,15.496408
1991,9669,2884,0,-3,-3,72,75,0,4.660916
1991,9635,3138,0,7,8,62,54,1,16.908192
1991,9958,3138,0,-1,-10,60,70,0,-1.656797
1991,7006,3172,0,5,8,76,68,1,-4.399233
1991,416,3206,0,15,41,117,76,1,35.74499
1991,2210,3240,0,-1,-17,70,87,0,-2.001158
1991,6635,3240,0,7,4,65,61,1,7.687181
1991,1588,3824,0,-13,-10,69,79,0,-25.538191
1991,2884,3824,0,-5,-22,60,82,0,-15.496408
1991,4155,3824,0,-1,18,83,65,1,-0.409605
1991,2346,3926,0,5,15,85,70,1,12.501065
1991,2613,3926,0,-3,-3,73,76,0,0.596994
1991,416,4155,0,2,-12,81,93,0,3.657701
1991,2346,4155,0,1,7,72,65,1,-0.382562
1991,3824,4155,0,1,-18,65,83,0,0.409605
1991,6154,4155,0,-11,-6,49,55,0,-16.918639
1991,6287,4155,0,2,-6,73,79,0,2.665588
1991,7006,4155,0,-3,-11,66,77,0,-8.974056
1991,10338,4568,0,7,6,71,65,1,4.624252
1991,1785,4738,0,-5,17,79,62,1,-3.713162
1991,9771,5252,0,1,1,85,84,1,-1.090615
1991,10508,5252,0,-7,-2,58,60,0,-7.821787
1991,2482,5354,0,-7,20,76,56,1,-4.725904
1991,9635,5519,0,15,34,99,65,1,32.11072
1991,79,5755,0,9,10,89,79,1,9.63798
1991,8411,5816,0,9,7,75,68,1,4.93708
1991,6704,5935,0,3,9,73,64,1,7.555584
1991,8211,5935,0,-5,-29,85,114,0,-5.958796
1991,10792,5984,0,-11,5,89,84,1,-15.167848
1991,6704,6086,0,11,13,67,54,1,13.561911
1991,1886,6120,0,-5,8,64,56,1,-1.815875
1991,4155,6154,0,11,6,55,49,1,16.918639
1991,2482,6287,0,-11,-26,67,93,0,-17.156866
1991,4155,6287,0,-2,6,79,73,1,-2.665588
1991,6378,6287,0,-15,-35,66,101,0,-27.192037
1991,8752,6287,0,-9,-3,72,75,0,-16.355195
1991,10026,6287,0,-8,-15,69,84,0,-14.863237
1991,6287,6378,0,15,35,101,66,1,27.192037
1991,3240,6635,0,-7,-4,61,65,0,-7.687181
1991,8411,6635,0,-3,17,91,74,1,-10.392607
1991,9084,6635,0,-15,-11,86,97,0,-27.242081
1991,5935,6704,0,-3,-9,64,73,0,-7.555584
1991,6086,6704,0,-11,-13,54,67,0,-13.561911
1991,8752,6704,0,-7,9,72,63,1,-11.391296
1991,2482,6938,0,1,3,71,68,1,1.798243
1991,9408,6938,0,9,-5,69,74,0,12.983836
1991,7965,6972,0,11,20,71,51,1,11.221331
1991,3172,7006,0,-5,-8,68,76,0,4.399233
1991,4155,7006,0,3,11,77,66,1,8.974056
1991,10026,7139,0,-1,2,50,48,1,3.771757
1991,8752,7207,0,-3,17,80,63,1,-2.631904
1991,8668,7363,0,13,-4,69,73,0,16.136459
1991,8752,7363,0,5,13,77,64,1,9.004997
1991,328,7465,0,1,3,79,76,1,8.195099
1991,294,7965,0,1,-4,77,81,0,7.430893
1991,1886,7965,0,-8,-12,69,81,0,-6.271036
1991,6972,7965,0,-11,-20,51,71,0,-11.221331
1991,9635,7965,0,2,12,77,65,1,14.748049
1991,9771,8099,0,9,10,82,72,1,4.363773
1991,5935,8211,0,5,29,114,85,1,5.958796
1991,294,8377,0,13,13,93,80,1,23.961721
1991,2346,8411,0,2,17,78,61,1,11.021414
1991,5816,8411,0,-9,-7,68,75,0,-4.93708
1991,6635,8411,0,3,-17,74,91,0,10.392607
1991,8888,8411,0,-1,-8,76,84,0,2.792423
1991,8888,8547,0,7,8,73,65,1,9.168703
1991,7363,8668,0,-13,4,73,69,1,-16.136459
1991,6287,8752,0,9,3,75,72,1,16.355195
1991,6704,8752,0,7,-9,63,72,0,11.391296
1991,7207,8752,0,3,-17,63,80,0,2.631904
1991,7363,8752,0,-5,-13,64,77,0,-9.004997
1991,8411,8888,0,1,8,84,76,1,-2.792423
1991,8547,8888,0,-7,-8,65,73,0,-9.168703
1991,6635,9084,0,15,11,97,86,1,27.242081
1991,6938,9408,0,-9,5,74,69,1,-12.983836
1991,2346,9476,0,13,29,102,73,1,22.505886
1991,2346,9635,0,-1,2,79,77,1,-8.214509
1991,3138,9635,0,-7,-8,54,62,0,-16.908192
1991,5519,9635,0,-15,-34,65,99,0,-32.11072
1991,7965,9635,0,-2,-12,65,77,0,-14.748049
1991,9771,9635,0,-3,-17,66,83,0,-20.389396
1991,2884,9669,0,3,3,75,72,1,-4.660916
1991,5252,9771,0,-1,-1,84,85,0,1.090615
1991,8099,9771,0,-9,-10,72,82,0,-4.363773
1991,9635,9771,0,3,17,83,66,1,20.389396
1991,3138,9958,0,1,10,70,60,1,1.656797
1991,6287,10026,0,8,15,84,69,1,14.863237
1991,7139,10026,0,1,-2,48,50,0,-3.771757
1991,1053,10060,0,-3,13,61,48,1,-7.221099
1991,79,10338,0,1,8,96,88,1,1.264547
1991,4568,10338,0,-7,-6,65,71,0,-4.624252
1991,5252,10508,0,7,2,60,58,1,7.821787
1991,1785,10792,0,3,16,66,50,1,11.324775
1991,5984,10792,0,11,-5,84,89,0,15.167848
1992,6288,80,0,1,9,64,55,1,4.609645
1992,8582,80,0,-7,-5,75,80,0,2.952553
1992,2614,295,0,-11,7,87,80,1,-19.403859
1992,5084,417,0,-3,2,82,80,1,-7.192387
1992,5756,417,0,-11,-11,69,80,0,-18.323882
1992,4739,1054,0,3,11,94,83,1,5.86778
1992,2347,1180,0,15,26,82,56,1,34.76424
1992,3961,1353,0,-3,2,76,74,1,5.358738
1992,2123,1455,0,-9,-38,47,85,0,-19.479731
1992,5084,1455,0,-2,-31,57,88,0,-7.915138
1992,5219,1455,0,-2,4,76,72,1,-2.076314
1992,5253,1455,0,-1,-12,65,77,0,-2.403486
1992,9854,1455,0,-5,-2,67,69,0,-7.940022
1992,5985,1786,0,1,-21,65,86,0,-0.999044
1992,6636,1786,0,8,23,78,55,1,9.488446
1992,1455,2123,0,9,38,85,47,1,19.479731
1992,6121,2211,0,-7,8,81,73,1,-2.833605
1992,1180,2347,0,-15,-26,56,82,0,-34.76424
1992,3825,2347,0,-1,-3,78,81,0,5.531127
1992,3927,2347,0,-8,-13,62,75,0,-5.921913
1992,4271,2347,0,-1,-1,103,104,0,-3.427723
1992,5219,2347,0,-5,-20,51,71,0,-5.65264
1992,7966,2347,0,-3,-12,69,81,0,-10.550666
1992,3825,2415,0,13,39,94,55,1,31.486753
1992,295,2614,0,11,-7,80,87,0,19.403859
1992,5219,2614,0,8,12,102,90,1,12.731366
1992,9854,2648,0,-1,5,55,50,1,-0.339679
1992,3139,2885,0,-3,-10,68,78,0,-2.569106
1992,3825,2885,0,1,11,85,74,1,15.344191
1992,5520,2885,0,-11,-10,68,78,0,-6.622303
1992,4982,2919,0,11,27,85,58,1,15.16826
1992,6705,3055,0,13,27,100,73,1,18.650535
1992,2885,3139,0,3,10,78,68,1,2.569106
1992,8178,3139,0,-5,-15,60,75,0,-4.964137
1992,3566,3241,0,-3,-5,60,65,0,-4.589996
1992,5084,3241,0,1,4,83,79,1,-4.129495
1992,9670,3241,0,5,-1,78,79,0,-4.176872
1992,3241,3566,0,3,5,65,60,1,4.589996
1992,4156,3616,0,15,33,100,67,1,39.472198
1992,2347,3825,0,1,3,81,78,1,-5.531127
1992,2415,3825,0,-13,-39,55,94,0,-31.486753
1992,2885,3825,0,-1,-11,74,85,0,-15.344191
1992,4739,3825,0,-5,-10,79,89,0,-9.529665
1992,9409,3825,0,1,-27,79,106,0,-9.104136
1992,2347,3927,0,8,13,75,62,1,5.921913
1992,8889,3927,0,1,-6,92,98,0,-6.749476
1992,1353,3961,0,3,-2,74,76,0,-5.358738
1992,4271,3961,0,8,8,106,98,1,6.338319
1992,3616,4156,0,-15,-33,67,100,0,-39.472198
1992,9854,4156,0,-8,6,66,60,1,-13.978757
1992,2347,4271,0,1,1,104,103,1,3.427723
1992,3961,4271,0,-8,-8,98,106,0,-6.338319
1992,4982,4271,0,-1,-10,77,87,0,-4.291611
1992,6739,4271,0,-13,-19,69,88,0,-24.563019
1992,7966,4305,0,9,2,78,76,1,5.462073
1992,9409,4603,0,7,16,85,69,1,8.297348
1992,10339,4603,0,-1,-23,58,81,0,1.960207
1992,1054,4739,0,-3,-11,83,94,0,-5.86778
1992,3825,4739,0,5,10,89,79,1,9.529665
1992,2919,4982,0,-11,-27,58,85,0,-15.16826
1992,4271,4982,0,1,10,87,77,1,4.291611
1992,8669,4982,0,-3,-6,71,77,0,-5.459164
1992,417,5084,0,3,-2,80,82,0,7.192387
1992,1455,5084,0,2,31,88,57,1,7.915138
1992,3241,5084,0,-1,-4,79,83,0,4.129495
1992,6973,5084,0,-5,-10,70,80,0,-3.129756
1992,6288,5185,0,9,5,68,63,1,9.745477
1992,1455,5219,0,2,-4,72,76,0,2.076314
1992,2347,5219,0,5,20,71,51,1,5.65264
1992,2614,5219,0,-8,-12,90,102,0,-12.731366
1992,6636,5219,0,5,-4,71,75,0,5.853786
1992,6705,5219,0,4,-3,72,75,0,3.378167
1992,8753,5219,0,-5,-7,66,73,0,-8.171943
1992,1455,5253,0,1,12,77,65,1,2.403486
1992,5452,5253,0,-7,-7,54,61,0,-12.126847
1992,7966,5389,0,1,17,88,71,1,-5.558943
1992,10475,5389,0,-7,-11,78,89,0,-8.986555
1992,5253,5452,0,7,7,61,54,1,12.126847
1992,2885,5520,0,11,10,78,68,1,6.622303
1992,6636,5658,0,15,27,83,56,1,33.237108
1992,417,5756,0,11,11,80,69,1,18.323882
1992,1786,5985,0,-1,21,86,65,1,0.999044
1992,2211,6121,0,7,-8,73,81,0,2.833605
1992,9409,6121,0,11,7,85,78,1,11.400357
1992,9443,6121,0,-1,-8,73,81,0,-3.95506
1992,80,6288,0,-1,-9,55,64,0,-4.609645
1992,5185,6288,0,-9,-5,63,68,0,-9.745477
1992,6636,6288,0,3,7,80,73,1,6.282596
1992,1786,6636,0,-8,-23,55,78,0,-9.488446
1992,5219,6636,0,-5,4,75,71,1,-5.853786
1992,5658,6636,0,-15,-27,56,83,0,-33.237108
1992,6288,6636,0,-3,-7,73,80,0,-6.282596
1992,9443,6671,0,-9,4,87,83,1,-15.08629
1992,3055,6705,0,-13,-27,73,100,0,-18.650535
1992,5219,6705,0,-4,3,75,72,1,-3.378167
1992,9140,6705,0,-8,-16,71,87,0,-10.4635
1992,4271,6739,0,13,19,88,69,1,24.563019
1992,5084,6973,0,5,10,80,70,1,3.129756
1992,8669,7140,0,5,8,51,43,1,4.438053
1992,9409,7432,0,15,20,73,53,1,24.086422
1992,2347,7966,0,3,12,81,69,1,10.550666
1992,4305,7966,0,-9,-2,76,78,0,-5.462073
1992,5389,7966,0,-1,-17,71,88,0,5.558943
1992,3139,8178,0,5,15,75,60,1,4.964137
1992,9140,8412,0,-3,4,61,57,1,-4.317972
1992,80,8582,0,7,5,80,75,1,-2.952553
1992,4982,8669,0,3,6,77,71,1,5.459164
1992,7140,8669,0,-5,-8,43,51,0,-4.438053
1992,5219,8753,0,5,7,73,66,1,8.171943
1992,3927,8889,0,-1,6,98,92,1,6.749476
1992,6705,9140,0,8,16,87,71,1,10.4635
1992,8412,9140,0,3,-4,57,61,0,4.317972
1992,3825,9409,0,-1,27,106,79,1,9.104136
1992,4603,9409,0,-7,-16,69,85,0,-8.297348
1992,6121,9409,0,-11,-7,78,85,0,-11.400357
1992,7432,9409,0,-15,-20,53,73,0,-24.086422
1992,6121,9443,0,1,8,81,73,1,3.95506
1992,6671,9443,0,9,-4,83,87,0,15.08629
1992,9670,9477,0,13,30,84,54,1,14.21856
1992,3241,9670,0,-5,1,79,78,1,4.176872
1992,9477,9670,0,-13,-30,54,84,0,-14.21856
1992,1455,9854,0,5,2,69,67,1,7.940022
1992,2648,9854,0,1,-5,50,55,0,0.339679
1992,4156,9854,0,8,-6,60,66,0,13.978757
1992,4603,10339,0,1,23,81,58,1,-1.960207
1992,5389,10475,0,7,11,89,78,1,8.986555
1993,7836,296,0,-13,3,64,61,1,-20.629051
1993,3533,418,0,-9,-30,64,94,0,-13.584875
1993,6289,418,0,3,6,80,74,1,11.882944
1993,8413,418,0,-1,-6,74,80,0,-4.19105
1993,4157,596,0,13,22,94,72,1,20.769453
1993,9960,738,0,11,20,92,72,1,19.323889
1993,4157,1055,0,5,14,90,76,1,9.223322
1993,8067,1055,0,-3,-9,71,80,0,-5.482788
1993,2348,1147,0,3,-5,77,82,0,13.689306
1993,4157,1147,0,4,17,93,76,1,9.747717
1993,4740,1147,0,-5,-2,64,66,0,-2.258547
1993,10340,1388,0,7,23,81,58,1,9.630189
1993,1820,1456,0,-13,-27,66,93,0,-25.026627
1993,6122,1456,0,-5,-37,55,92,0,-12.62216
1993,6289,1456,0,1,7,75,68,1,7.340307
1993,10062,1456,0,-4,-17,54,71,0,-7.034106
1993,5220,1590,0,15,32,84,52,1,25.850796
1993,1456,1820,0,13,27,93,66,1,25.026627
1993,4604,2124,0,9,6,76,70,1,15.483887
1993,1147,2348,0,-3,5,82,77,1,-13.689306
1993,7548,2348,0,-11,-35,70,105,0,-16.077136
1993,6289,2552,0,15,20,85,65,1,31.157656
1993,2886,2649,0,11,12,82,70,1,9.06172
1993,2649,2886,0,-11,-12,70,82,0,-9.06172
1993,4272,2886,0,2,25,106,81,1,7.231988
1993,9141,2886,0,-8,-31,63,94,0,-8.985548
1993,10232,2886,0,-4,-3,78,81,0,-2.640234
1993,5220,3022,0,11,8,72,64,1,11.108131
1993,6088,3022,0,7,-14,68,82,0,-1.377673
1993,8247,3022,0,-1,-10,80,90,0,-10.269113
1993,8247,3242,0,-9,15,93,78,1,-12.904793
1993,418,3533,0,9,30,94,64,1,13.584875
1993,4488,3753,0,-5,-3,72,75,0,-3.682096
1993,9960,3753,0,3,17,85,68,1,7.466015
1993,4157,3826,0,-1,6,83,77,1,-3.728456
1993,4604,3826,0,-3,-13,69,82,0,-11.200454
1993,10726,3826,0,-15,-43,54,97,0,-21.848531
1993,10794,3826,0,-8,-3,70,73,0,-16.211806
1993,9478,3928,0,-9,-13,69,82,0,-12.331208
1993,10340,3928,0,-1,6,84,78,1,-3.282285
1993,9410,3962,0,-1,11,81,70,1,-9.187696
1993,596,4157,0,-13,-22,72,94,0,-20.769453
1993,1055,4157,0,-5,-14,76,90,0,-9.223322
1993,1147,4157,0,-4,-17,76,93,0,-9.747717
1993,3826,4157,0,1,-6,77,83,0,3.728456
1993,6289,4157,0,1,10,78,68,1,6.663212
1993,9141,4191,0,-5,2,55,53,1,-1.554133
1993,2886,4272,0,-2,-25,81,106,0,-7.231988
1993,5220,4272,0,0,3,81,78,1,-2.825517
1993,7399,4272,0,-15,-44,52,96,0,-30.066299
1993,9773,4272,0,-7,-21,62,83,0,-11.652407
1993,10340,4272,0,-4,-34,69,103,0,-8.175064
1993,3753,4488,0,5,3,75,72,1,3.682096
1993,2124,4604,0,-9,-6,70,76,0,-15.483887
1993,3826,4604,0,3,13,82,69,1,11.200454
1993,6706,4604,0,-1,-15,63,78,0,0.573602
1993,1147,4740,0,5,2,66,64,1,2.258547
1993,10062,4813,0,5,12,78,66,1,11.039153
1993,6706,4881,0,7,12,74,62,1,-0.950302
1993,6906,4983,0,-11,-4,50,54,0,-8.646115
1993,10062,4983,0,-3,15,71,56,1,-0.491706
1993,10232,5085,0,3,3,55,52,1,2.635862
1993,1590,5220,0,-15,-32,52,84,0,-25.850796
1993,3022,5220,0,-11,-8,64,72,0,-11.108131
1993,4272,5220,0,0,-3,78,81,0,2.825517
1993,6289,5220,0,0,6,77,71,1,6.521885
1993,8754,5220,0,-6,-5,72,77,0,-10.383016
1993,9410,5220,0,-8,-2,84,86,0,-11.758066
1993,8754,5390,0,3,14,75,61,1,-2.48739
1993,6122,5986,0,3,14,93,79,1,-2.700575
1993,3022,6088,0,-7,14,82,68,1,1.377673
1993,1456,6122,0,5,37,92,55,1,12.62216
1993,5986,6122,0,-3,-14,79,93,0,2.700575
1993,10794,6156,0,-1,18,73,55,1,-3.29424
1993,418,6289,0,-3,-6,74,80,0,-11.882944
1993,1456,6289,0,-1,-7,68,75,0,-7.340307
1993,2552,6289,0,-15,-20,65,85,0,-31.157656
1993,4157,6289,0,-1,-10,68,78,0,-6.663212
1993,5220,6289,0,0,-6,71,77,0,-6.521885
1993,7297,6289,0,-7,-45,67,112,0,-18.673271
1993,4604,6706,0,1,15,78,63,1,-0.573602
1993,4881,6706,0,-7,-12,62,74,0,0.950302
1993,4983,6906,0,11,4,54,50,1,8.646115
1993,9773,7008,0,1,21,86,65,1,3.304744
1993,7297,7209,0,1,6,74,68,1,-3.298536
1993,6289,7297,0,7,45,112,67,1,18.673271
1993,7209,7297,0,-1,-6,68,74,0,3.298536
1993,4272,7399,0,15,44,96,52,1,30.066299
1993,2348,7548,0,11,35,105,70,1,16.077136
1993,296,7836,0,13,-3,61,64,0,20.629051
1993,8754,7836,0,8,11,68,57,1,11.339772
1993,8822,7967,0,-13,-22,59,81,0,-20.563319
1993,10232,7967,0,-5,4,72,68,1,-4.232117
1993,1055,8067,0,3,9,80,71,1,5.482788
1993,3022,8247,0,1,10,90,80,1,10.269113
1993,3242,8247,0,9,-15,78,93,0,12.904793
1993,418,8413,0,1,6,80,74,1,4.19105
1993,8992,8413,0,-7,-18,67,85,0,-8.929352
1993,5220,8754,0,6,5,77,72,1,10.383016
1993,5390,8754,0,-3,-14,61,75,0,2.48739
1993,7836,8754,0,-8,-11,57,68,0,-11.339772
1993,9960,8754,0,4,-8,59,67,0,7.977433
1993,7967,8822,0,13,22,81,59,1,20.563319
1993,8413,8992,0,7,18,85,67,1,8.929352
1993,2886,9141,0,8,31,94,63,1,8.985548
1993,4191,9141,0,5,-2,53,55,0,1.554133
1993,3962,9410,0,1,-11,70,81,0,9.187696
1993,5220,9410,0,8,2,86,84,1,11.758066
1993,3928,9478,0,9,13,82,69,1,12.331208
1993,4272,9773,0,7,21,83,62,1,11.652407
1993,7008,9773,0,-1,-21,65,86,0,-3.304744
1993,738,9960,0,-11,-20,72,92,0,-19.323889
1993,3753,9960,0,-3,-17,68,85,0,-7.466015
1993,8754,9960,0,-4,8,67,59,1,-7.977433
1993,1456,10062,0,4,17,71,54,1,7.034106
1993,4813,10062,0,-5,-12,66,78,0,-11.039153
1993,4983,10062,0,3,-15,56,71,0,0.491706
1993,2886,10232,0,4,3,81,78,1,2.640234
1993,5085,10232,0,-3,-3,52,55,0,-2.635862
1993,7967,10232,0,5,-4,68,72,0,4.232117
1993,1388,10340,0,-7,-23,58,81,0,-9.630189
1993,3928,10340,0,1,-6,78,84,0,3.282285
1993,4272,10340,0,4,34,103,69,1,8.175064
1993,3826,10726,0,15,43,97,54,1,21.848531
1993,3826,10794,0,8,3,73,70,1,16.211806
1993,6156,10794,0,1,-18,55,73,0,3.29424
1994,7176,82,0,1,-6,70,76,0,10.246226
1994,7210,82,0,8,10,83,73,1,11.864362
1994,419,297,0,1,9,91,82,1,-0.002832
1994,4605,297,0,-1,-12,70,82,0,-4.514662
1994,4673,297,0,-13,-26,55,81,0,-27.150162
1994,5391,297,0,1,-20,72,92,0,-8.598066
1994,10063,297,0,-5,-13,58,71,0,-14.369293
1994,297,419,0,-1,-9,82,91,0,0.002832
1994,2349,419,0,-1,-4,72,76,0,-5.143596
1994,3141,419,0,-8,-12,73,85,0,-6.256425
1994,5221,419,0,-2,-8,68,76,0,-5.654264
1994,5893,419,0,-15,-15,79,94,0,-34.760287
1994,9176,419,0,-11,-19,84,103,0,-13.707095
1994,4605,739,0,11,9,67,58,1,17.513798
1994,2788,773,0,6,8,74,66,1,-0.922371
1994,3827,773,0,4,-9,68,77,0,-0.975328
1994,6290,773,0,8,-3,72,75,0,6.401044
1994,10409,773,0,1,-3,64,67,0,-2.983712
1994,10511,1148,0,-7,4,61,57,1,-5.399907
1994,4158,1389,0,9,29,102,73,1,17.745261
1994,10673,1457,0,-1,8,80,72,1,-0.403491
1994,10341,1618,0,7,10,68,58,1,9.339419
1994,2788,1788,0,-1,9,69,60,1,-7.686773
1994,3023,1788,0,-8,-12,63,75,0,-14.496632
1994,7400,1788,0,-13,-18,46,64,0,-24.634798
1994,8755,2315,0,9,22,61,39,1,14.007203
1994,419,2349,0,1,4,76,72,1,5.143596
1994,2788,2349,0,-1,-5,65,70,0,-2.839392
1994,4882,2349,0,-4,-10,49,59,0,-3.635394
1994,5255,2349,0,-5,-11,74,85,0,-2.844848
1994,7210,2349,0,1,-9,60,69,0,2.918928
1994,9244,2349,0,-13,-12,70,82,0,-24.974166
1994,773,2788,0,-6,-8,66,74,0,0.922371
1994,1788,2788,0,1,-9,60,69,0,7.686773
1994,2349,2788,0,1,5,70,65,1,2.839392
1994,4124,2788,0,-11,-2,62,64,0,-14.025391
1994,6907,2788,0,-8,-12,58,70,0,-10.504325
1994,1788,3023,0,8,12,75,63,1,14.496632
1994,9278,3023,0,3,-5,46,51,0,6.231439
1994,419,3141,0,8,12,85,73,1,6.256425
1994,3754,3141,0,1,-7,77,84,0,1.79374
1994,8671,3447,0,9,14,92,78,1,16.834587
1994,3141,3754,0,-1,7,84,77,1,-1.79374
1994,773,3827,0,-4,9,77,68,1,0.975328
1994,6604,3827,0,-7,-12,72,84,0,-3.762627
1994,8755,3827,0,1,-9,58,67,0,1.772744
1994,2788,4124,0,11,2,64,62,1,14.025391
1994,1389,4158,0,-9,-29,73,102,0,-17.745261
1994,7210,4158,0,3,5,83,78,1,1.216835
1994,10341,4158,0,-1,-11,58,69,0,-6.352951
1994,4882,4273,0,-3,12,75,63,1,-7.407314
1994,8823,4273,0,-11,-13,70,83,0,-22.550026
1994,6290,4439,0,15,20,71,51,1,30.188634
1994,297,4605,0,1,12,82,70,1,4.514662
1994,739,4605,0,-11,-9,58,67,0,-17.513798
1994,5289,4605,0,-3,-5,55,60,0,0.0726
1994,297,4673,0,13,26,81,55,1,27.150162
1994,2349,4882,0,4,10,59,49,1,3.635394
1994,4273,4882,0,3,-12,63,75,0,7.407314
1994,9445,4882,0,-5,-22,59,81,0,-8.581802
1994,4984,4950,0,8,-8,87,95,0,3.680478
1994,5221,4950,0,7,7,78,71,1,4.643608
1994,8482,4950,0,3,-8,66,74,0,-0.381826
1994,4950,4984,0,-8,8,95,87,1,-3.680478
1994,8959,4984,0,-13,-18,60,78,0,-17.259123
1994,419,5221,0,2,8,76,68,1,5.654264
1994,4950,5221,0,-7,-7,71,78,0,-4.643608
1994,6975,5221,0,-11,-4,74,78,0,-8.954565
1994,8891,5221,0,-3,-5,79,84,0,-3.577519
1994,2349,5255,0,5,11,85,74,1,2.844848
1994,7968,5255,0,-3,-11,73,84,0,-1.619639
1994,4605,5289,0,3,5,60,55,1,-0.0726
1994,7549,5289,0,-5,-14,60,74,0,-12.400261
1994,297,5391,0,-1,20,92,72,1,8.598066
1994,5859,5391,0,-15,-23,53,76,0,-22.93341
1994,8671,5391,0,-3,-10,88,98,0,3.548855
1994,10673,5391,0,-8,-13,96,109,0,0.077905
1994,5391,5859,0,15,23,76,53,1,22.93341
1994,419,5893,0,15,15,94,79,1,34.760287
1994,6907,5987,0,-5,10,90,80,1,-8.744231
1994,10063,6089,0,3,3,57,54,1,-0.619413
1994,6707,6123,0,9,10,65,55,1,11.485329
1994,773,6290,0,-8,3,75,72,1,-6.401044
1994,4439,6290,0,-15,-20,51,71,0,-30.188634
1994,3827,6604,0,7,12,84,72,1,3.762627
1994,6123,6707,0,-9,-10,55,65,0,-11.485329
1994,9176,6707,0,-8,2,82,80,1,-7.820638
1994,2788,6907,0,8,12,70,58,1,10.504325
1994,5987,6907,0,5,-10,80,90,0,8.744231
1994,5221,6975,0,11,4,78,74,1,8.954565
1994,82,7176,0,-1,6,76,70,1,-10.246226
1994,82,7210,0,-8,-10,73,83,0,-11.864362
1994,2349,7210,0,-1,9,69,60,1,-2.918928
1994,4158,7210,0,-3,-5,78,83,0,-1.216835
1994,9377,7210,0,-15,-31,67,98,0,-27.59097
1994,1788,7400,0,13,18,64,46,1,24.634798
1994,5289,7549,0,5,14,74,60,1,12.400261
1994,5255,7968,0,3,11,84,73,1,1.619639
1994,4950,8482,0,-3,8,74,66,1,0.381826
1994,3447,8671,0,-9,-14,78,92,0,-16.834587
1994,5391,8671,0,3,10,98,88,1,-3.548855
1994,10511,8671,0,-8,-5,59,64,0,-9.303662
1994,2315,8755,0,-9,-22,39,61,0,-14.007203
1994,3827,8755,0,-1,9,67,58,1,-1.772744
1994,4273,8823,0,11,13,83,70,1,22.550026
1994,5221,8891,0,3,5,84,79,1,3.577519
1994,10233,8891,0,-5,-14,77,91,0,-5.879199
1994,4984,8959,0,13,18,78,60,1,17.259123
1994,419,9176,0,11,19,103,84,1,13.707095
1994,6707,9176,0,8,-2,80,82,0,7.820638
1994,9411,9176,0,7,-10,102,112,0,7.049229
1994,2349,9244,0,13,12,82,70,1,24.974166
1994,3023,9278,0,-3,5,51,46,1,-6.231439
1994,7210,9377,0,15,31,98,67,1,27.59097
1994,9176,9411,0,-7,10,112,102,1,-7.049229
1994,4882,9445,0,5,22,81,59,1,8.581802
1994,297,10063,0,5,13,71,58,1,14.369293
1994,6089,10063,0,-3,-3,54,57,0,0.619413
1994,8891,10233,0,5,14,91,77,1,5.879199
1994,1618,10341,0,-7,-10,58,68,0,-9.339419
1994,4158,10341,0,1,11,69,58,1,6.352951
1994,773,10409,0,-1,3,67,64,1,2.983712
1994,1148,10511,0,7,-4,57,61,0,5.399907
1994,8671,10511,0,8,5,64,59,1,9.303662
1994,1457,10673,0,1,-8,72,80,0,0.403491
1994,5391,10673,0,8,13,109,96,1,-0.077905
1995,6708,83,0,1,14,66,52,1,5.563506
1995,6908,83,0,-7,-6,85,91,0,-7.191072
1995,5188,298,0,-7,9,71,62,1,-11.191104
1995,598,332,0,-7,-15,66,81,0,-12.333503
1995,4274,332,0,4,24,97,73,1,10.689105
1995,4815,332,0,-8,-10,54,64,0,-8.939231
1995,5087,420,0,-4,-5,91,96,0,-2.852321
1995,6291,420,0,0,-7,68,75,0,6.746585
1995,8672,420,0,-5,-2,94,96,0,-1.228387
1995,9245,420,0,-13,-1,78,79,0,-16.602077
1995,9412,420,0,1,11,89,78,1,6.887839
1995,10064,420,0,-2,-7,61,68,0,3.810221
1995,332,598,0,7,15,81,66,1,12.333503
1995,9143,1057,0,-1,6,76,70,1,-2.296702
1995,8585,1356,0,-3,2,70,68,1,4.975442
1995,1789,1390,0,13,29,100,71,1,19.516869
1995,1789,1458,0,5,5,96,91,1,0.07369
1995,8756,1458,0,-3,-6,71,77,0,-6.052255
1995,4159,1653,0,15,14,82,68,1,29.6203
1995,1390,1789,0,-13,-29,71,100,0,-19.516869
1995,1458,1789,0,-5,-5,91,96,0,-0.07369
1995,4951,1789,0,-1,-10,89,99,0,4.384088
1995,9412,1789,0,1,6,102,96,1,5.140305
1995,6708,2316,0,9,24,73,49,1,15.397725
1995,3964,2789,0,3,3,64,61,1,1.727527
1995,9412,2854,0,15,36,92,56,1,34.038712
1995,6291,3142,0,4,10,74,64,1,12.129174
1995,10444,3142,0,-8,-2,51,53,0,-3.092875
1995,10796,3142,0,-5,-5,63,68,0,-0.800081
1995,4951,3278,0,11,24,87,63,1,13.711855
1995,9177,3755,0,5,6,68,62,1,0.149916
1995,5392,3828,0,1,5,65,60,1,-3.80339
1995,2789,3964,0,-3,-3,61,64,0,-1.727527
1995,6291,3964,0,5,22,73,51,1,6.146028
1995,1653,4159,0,-15,-14,68,82,0,-29.6203
1995,10064,4159,0,-3,9,67,58,1,-3.125275
1995,10234,4159,0,-7,-5,70,75,0,-16.433514
1995,332,4274,0,-4,-24,73,97,0,-10.689105
1995,5691,4274,0,-15,-46,67,113,0,-34.594085
1995,6291,4274,0,-1,13,74,61,1,-4.695747
1995,9143,4274,0,-8,-22,60,82,0,-18.417521
1995,9775,4490,0,9,12,76,64,1,11.85966
1995,5087,4606,0,5,21,77,56,1,1.629487
1995,332,4815,0,8,10,64,54,1,8.939231
1995,6674,4815,0,9,-10,67,77,0,7.447854
1995,1789,4951,0,1,10,99,89,1,-4.384088
1995,3278,4951,0,-11,-24,63,87,0,-13.711855
1995,8892,4951,0,-8,-14,68,82,0,-7.110653
1995,6708,4985,0,-2,14,68,54,1,-1.867308
1995,8551,4985,0,-13,-17,51,68,0,-25.692782
1995,8585,4985,0,-8,-22,53,75,0,-9.160604
1995,9177,4985,0,-4,-25,51,76,0,-10.72063
1995,420,5087,0,4,5,96,91,1,2.852321
1995,4606,5087,0,-5,-21,56,77,0,-1.629487
1995,7211,5087,0,3,-2,73,75,0,0.081193
1995,298,5188,0,7,-9,62,71,0,11.191104
1995,10064,5188,0,8,6,60,54,1,11.480789
1995,10234,5222,0,1,6,82,76,1,-3.260869
1995,10444,5256,0,-11,7,79,72,1,-10.293002
1995,8483,5290,0,-1,3,64,61,1,3.013234
1995,7838,5358,0,-7,-8,67,75,0,-7.243035
1995,9412,5358,0,4,19,86,67,1,6.087326
1995,9775,5358,0,1,-14,64,78,0,-0.560073
1995,3828,5392,0,-1,-5,60,65,0,3.80339
1995,9412,5392,0,7,1,75,74,1,11.946448
1995,4274,5691,0,15,46,113,67,1,34.594085
1995,6291,5759,0,13,10,80,70,1,26.621803
1995,10342,5894,0,15,32,79,47,1,33.378403
1995,10064,6224,0,9,24,96,72,1,16.767444
1995,420,6291,0,0,7,75,68,1,-6.746585
1995,3142,6291,0,-4,-10,64,74,0,-12.129174
1995,3964,6291,0,-5,-22,51,73,0,-6.146028
1995,4274,6291,0,1,-13,61,74,0,4.695747
1995,5759,6291,0,-13,-10,70,80,0,-26.621803
1995,4815,6674,0,-9,10,77,67,1,-7.447854
1995,83,6708,0,-1,-14,52,66,0,-5.563506
1995,2316,6708,0,-9,-24,49,73,0,-15.397725
1995,4985,6708,0,2,-14,54,68,0,1.867308
1995,9412,6708,0,3,13,74,61,1,2.174317
1995,10342,6708,0,3,-5,66,71,0,-2.264179
1995,9177,6742,0,8,12,64,52,1,8.977924
1995,10030,6742,0,11,-8,81,89,0,13.390846
1995,8892,6806,0,-5,17,90,73,1,-0.180097
1995,83,6908,0,7,6,91,85,1,7.191072
1995,5087,7211,0,-3,2,75,73,1,-0.081193
1995,10512,7211,0,-11,-1,48,49,0,-9.486861
1995,8672,7550,0,3,4,96,92,1,7.559121
1995,5358,7838,0,7,8,75,67,1,7.243035
1995,5290,8483,0,1,-3,61,64,0,-3.013234
1995,10342,8483,0,8,5,64,59,1,1.872691
1995,4985,8551,0,13,17,68,51,1,25.692782
1995,1356,8585,0,3,-2,68,70,0,-4.975442
1995,4985,8585,0,8,22,75,53,1,9.160604
1995,420,8672,0,5,2,96,94,1,1.228387
1995,7550,8672,0,-3,-4,92,96,0,-7.559121
1995,1458,8756,0,3,6,77,71,1,6.052255
1995,4951,8892,0,8,14,82,68,1,7.110653
1995,6806,8892,0,5,-17,73,90,0,0.180097
1995,1057,9143,0,1,-6,70,76,0,2.296702
1995,4274,9143,0,8,22,82,60,1,18.417521
1995,3755,9177,0,-5,-6,62,68,0,-0.149916
1995,4985,9177,0,4,25,76,51,1,10.72063
1995,6742,9177,0,-8,-12,52,64,0,-8.977924
1995,420,9245,0,13,1,79,78,1,16.602077
1995,420,9412,0,-1,-11,78,89,0,-6.887839
1995,1789,9412,0,-1,-6,96,102,0,-5.140305
1995,2854,9412,0,-15,-36,56,92,0,-34.038712
1995,5358,9412,0,-4,-19,67,86,0,-6.087326
1995,5392,9412,0,-7,-1,74,75,0,-11.946448
1995,6708,9412,0,-3,-13,61,74,0,-2.174317
1995,4490,9775,0,-9,-12,64,76,0,-11.85966
1995,5358,9775,0,-1,14,78,64,1,0.560073
1995,6742,10030,0,-11,8,89,81,1,-13.390846
1995,420,10064,0,2,7,68,61,1,-3.810221
1995,4159,10064,0,3,-9,58,67,0,3.125275
1995,5188,10064,0,-8,-6,54,60,0,-11.480789
1995,6224,10064,0,-9,-24,72,96,0,-16.767444
1995,4159,10234,0,7,5,75,70,1,16.433514
1995,5222,10234,0,-1,-6,76,82,0,3.260869
1995,5894,10342,0,-15,-32,47,79,0,-33.378403
1995,6708,10342,0,-3,5,71,66,1,2.264179
1995,8483,10342,0,-8,-5,59,64,0,-1.872691
1995,3142,10444,0,8,2,53,51,1,3.092875
1995,5256,10444,0,11,-7,72,79,0,10.293002
1995,7211,10512,0,11,1,49,48,1,9.486861
1995,3142,10796,0,5,5,68,63,1,0.800081
1996,3931,299,0,-3,-14,73,87,0,2.699178
1996,4160,299,0,1,3,83,80,1,3.5843
1996,9929,299,0,-11,-39,51,90,0,-21.489753
1996,4884,421,0,8,-9,56,65,0,4.186463
1996,4986,421,0,11,16,79,63,1,9.755666
1996,6943,421,0,7,-6,80,86,0,7.543608
1996,3245,565,0,11,11,90,79,1,18.237688
1996,3245,775,0,8,14,103,89,1,0.399892
1996,3829,775,0,5,-13,51,64,0,1.60832
1996,8586,877,0,-1,8,66,58,1,5.019406
1996,3965,1150,0,7,10,74,64,1,-1.944684
1996,9776,1218,0,9,29,72,43,1,17.138636
1996,3245,1459,0,-1,-17,70,87,0,-5.288427
1996,5359,1459,0,-3,10,73,63,1,-8.290713
1996,8757,1459,0,-5,-13,65,78,0,-12.532578
1996,9572,1459,0,-13,-5,61,66,0,-25.57307
1996,3177,1527,0,1,7,81,74,1,4.913779
1996,1790,1654,0,15,9,68,59,1,32.867656
1996,1654,1790,0,-15,-9,59,68,0,-32.867656
1996,2487,1790,0,-8,-14,81,95,0,-16.71435
1996,5359,1790,0,-4,5,60,55,1,-12.964752
1996,5088,2317,0,7,-12,63,75,0,4.2504
1996,8673,2317,0,8,11,69,58,1,7.301381
1996,2487,2351,0,-1,15,75,60,1,-6.465243
1996,1790,2487,0,8,14,95,81,1,16.71435
1996,2351,2487,0,1,-15,60,75,0,6.465243
1996,3931,3025,0,5,2,81,79,1,11.59964
1996,4986,3143,0,1,24,86,62,1,-3.013833
1996,5662,3143,0,-13,-37,56,93,0,-28.525042
1996,6091,3143,0,-5,-11,62,73,0,-12.348204
1996,8995,3143,0,-1,-8,90,98,0,-9.027503
1996,1527,3177,0,-1,-7,74,81,0,-4.913779
1996,7212,3177,0,7,-7,69,76,0,0.117236
1996,8673,3177,0,4,2,83,81,1,-0.686766
1996,565,3245,0,-11,-11,79,90,0,-18.237688
1996,775,3245,0,-8,-14,89,103,0,-0.399892
1996,1459,3245,0,1,17,87,70,1,5.288427
1996,775,3829,0,-5,13,64,51,1,-1.60832
1996,299,3931,0,3,14,87,73,1,-2.699178
1996,3025,3931,0,-5,-2,79,81,0,-11.59964
1996,1150,3965,0,-7,-10,64,74,0,1.944684
1996,9776,3965,0,1,6,73,67,1,8.167229
1996,299,4160,0,-1,-3,80,83,0,-3.5843
1996,7504,4160,0,-13,-38,54,92,0,-25.611047
1996,7839,4160,0,-8,-25,51,76,0,-11.901322
1996,8673,4160,0,-2,3,60,57,1,-2.991016
1996,6091,4194,0,3,21,69,48,1,2.521861
1996,4986,4275,0,0,-7,74,81,0,-10.620197
1996,7771,4275,0,-15,-38,72,110,0,-33.838309
1996,8673,4275,0,-3,-9,67,76,0,-13.051583
1996,9776,4275,0,-3,-31,70,101,0,-12.180707
1996,10099,4275,0,-8,-24,60,84,0,-19.966494
1996,10343,4275,0,-1,-20,63,83,0,-11.548169
1996,9178,4607,0,-5,-2,80,82,0,-2.118585
1996,10031,4607,0,3,-4,64,68,0,5.731035
1996,10343,4607,0,4,1,60,59,1,4.567646
1996,421,4884,0,-8,9,65,56,1,-4.186463
1996,5490,4884,0,-9,-24,44,68,0,-16.07297
1996,7839,4952,0,-3,12,91,79,1,-7.073461
1996,421,4986,0,-11,-16,63,79,0,-9.755666
1996,3143,4986,0,-1,-24,62,86,0,3.013833
1996,4275,4986,0,0,7,81,74,1,10.620197
1996,8586,4986,0,-8,-5,74,79,0,-5.534359
1996,9379,4986,0,-15,-22,70,92,0,-30.852912
1996,2317,5088,0,-7,12,75,63,1,-4.2504
1996,8893,5223,0,-3,4,80,76,1,-3.869332
1996,1459,5359,0,3,-10,63,73,0,8.290713
1996,1790,5359,0,4,-5,55,60,0,12.964752
1996,7144,5359,0,-8,-22,41,63,0,-12.315691
1996,8673,5359,0,1,8,77,69,1,3.374538
1996,9895,5359,0,-7,-7,51,58,0,-7.198544
1996,4884,5490,0,9,24,68,44,1,16.07297
1996,8673,5558,0,9,33,88,55,1,9.366226
1996,3143,5662,0,13,37,93,56,1,28.525042
1996,8995,5821,0,11,1,74,73,1,10.152453
1996,3143,6091,0,5,11,73,62,1,12.348204
1996,4194,6091,0,-3,-21,48,69,0,-2.521861
1996,6292,6159,0,5,21,83,62,1,12.44553
1996,6159,6292,0,-5,-21,62,83,0,-12.44553
1996,8995,6292,0,3,19,92,73,1,-4.49802
1996,8757,6675,0,3,18,61,43,1,-3.138785
1996,421,6943,0,-7,6,86,80,1,-7.543608
1996,10031,7045,0,11,34,92,58,1,17.828519
1996,5359,7144,0,8,22,63,41,1,12.315691
1996,9413,7144,0,9,-2,41,43,0,12.569739
1996,3177,7212,0,-7,7,76,69,1,-0.117236
1996,10167,7212,0,-15,-2,71,73,0,-24.238693
1996,4160,7504,0,13,38,92,54,1,25.611047
1996,4275,7771,0,15,38,110,72,1,33.838309
1996,4160,7839,0,8,25,76,51,1,11.901322
1996,4952,7839,0,3,-12,79,91,0,7.073461
1996,877,8586,0,1,-8,58,66,0,-5.019406
1996,4986,8586,0,8,5,79,74,1,5.534359
1996,2317,8673,0,-8,-11,58,69,0,-7.301381
1996,3177,8673,0,-4,-2,81,83,0,0.686766
1996,4160,8673,0,2,-3,57,60,0,2.991016
1996,4275,8673,0,3,9,76,67,1,13.051583
1996,5359,8673,0,-1,-8,69,77,0,-3.374538
1996,5558,8673,0,-9,-33,55,88,0,-9.366226
1996,1459,8757,0,5,13,78,65,1,12.532578
1996,6675,8757,0,-3,-18,43,61,0,3.138785
1996,5223,8893,0,3,-4,76,80,0,3.869332
1996,10343,8893,0,8,3,65,62,1,7.360027
1996,3143,8995,0,1,8,98,90,1,9.027503
1996,5821,8995,0,-11,-1,73,74,0,-10.152453
1996,6292,8995,0,-3,-19,73,92,0,4.49802
1996,4607,9178,0,5,2,82,80,1,2.118585
1996,4986,9379,0,15,22,92,70,1,30.852912
1996,7144,9413,0,-9,2,43,41,1,-12.569739
1996,10343,9481,0,13,12,62,50,1,22.454743
1996,1459,9572,0,13,5,66,61,1,25.57307
1996,1218,9776,0,-9,-29,43,72,0,-17.138636
1996,3965,9776,0,-1,-6,67,73,0,-8.167229
1996,4275,9776,0,3,31,101,70,1,12.180707
1996,5359,9895,0,7,7,58,51,1,7.198544
1996,299,9929,0,11,39,90,51,1,21.489753
1996,4607,10031,0,-3,4,68,64,1,-5.731035
1996,7045,10031,0,-11,-34,58,92,0,-17.828519
1996,4275,10099,0,8,24,84,60,1,19.966494
1996,10513,10099,0,1,-13,48,61,0,-2.505227
1996,7212,10167,0,15,2,73,71,1,24.238693
1996,4275,10343,0,1,20,83,63,1,11.548169
1996,4607,10343,0,-4,-1,59,60,0,-4.567646
1996,8893,10343,0,-8,-3,62,65,0,-7.360027
1996,9481,10343,0,-13,-12,50,62,0,-22.454743
1996,10099,10513,0,-1,13,61,48,1,2.505227
1997,1621,300,0,-8,-4,69,73,0,-16.889695
1997,4161,300,0,3,-3,82,85,0,6.06904
1997,4276,300,0,3,-5,79,84,0,8.264158
1997,6293,300,0,3,-8,58,66,0,2.209321
1997,7179,300,0,-6,-4,92,96,0,-8.78639
1997,8105,300,0,-9,-8,57,65,0,-17.711386
1997,8451,776,0,1,4,81,77,1,1.104403
1997,9930,776,0,-7,-7,66,73,0,-8.020938
1997,9179,810,0,7,29,81,52,1,11.344906
1997,1460,1025,0,11,17,86,69,1,13.25531
1997,6293,1151,0,4,6,63,57,1,6.314894
1997,7145,1151,0,-7,-3,52,55,0,-10.46352
1997,10032,1151,0,1,-7,68,75,0,-0.714953
1997,9414,1324,0,13,34,109,75,1,22.355792
1997,3144,1358,0,-3,-12,67,79,0,-0.055826
1997,9777,1358,0,5,19,77,58,1,6.159596
1997,3178,1392,0,11,-3,70,73,0,12.940645
1997,3757,1392,0,8,-12,63,75,0,14.877445
1997,7179,1392,0,4,6,71,65,1,11.772184
1997,1025,1460,0,-11,-17,69,86,0,-13.25531
1997,3966,1460,0,-3,1,67,66,1,-8.321946
1997,5190,1528,0,-9,-12,56,68,0,-8.60148
1997,5292,1528,0,3,6,90,84,1,5.176121
1997,9179,1528,0,-1,-6,59,65,0,-3.079321
1997,300,1621,0,8,4,73,69,1,16.889695
1997,4953,1621,0,7,-9,66,75,0,14.242941
1997,3830,1689,0,1,-18,62,80,0,5.2933
1997,6293,1689,0,8,17,73,56,1,14.515564
1997,8139,1824,0,13,-13,65,78,0,18.688896
1997,8894,1824,0,5,1,82,81,1,15.668481
1997,5761,2352,0,-13,-3,68,71,0,-29.864277
1997,7179,2352,0,-8,11,98,87,1,-11.729485
1997,6293,2721,0,15,8,82,74,1,29.699102
1997,1358,3144,0,3,12,79,67,1,0.055826
1997,1392,3178,0,-11,3,73,70,1,-12.940645
1997,1392,3757,0,-8,12,75,63,1,-14.877445
1997,9675,3757,0,-5,-13,77,90,0,-1.957548
1997,3966,3791,0,5,12,69,57,1,1.545708
1997,1689,3830,0,-1,18,80,62,1,-5.2933
1997,4276,3932,0,7,6,75,69,1,13.63147
1997,10066,3932,0,-1,-13,60,73,0,-1.195455
1997,1460,3966,0,3,-1,66,67,0,8.321946
1997,3791,3966,0,-5,-12,57,69,0,-1.545708
1997,9414,3966,0,4,1,74,73,1,3.158059
1997,4161,4036,0,15,14,78,64,1,40.029357
1997,300,4161,0,-3,3,85,82,1,-6.06904
1997,4036,4161,0,-15,-14,64,78,0,-40.029357
1997,7213,4161,0,-7,-14,61,75,0,-15.884346
1997,300,4276,0,-3,5,84,79,1,-8.264158
1997,3932,4276,0,-7,-6,69,75,0,-13.63147
1997,5292,4276,0,0,-9,69,78,0,-6.885009
1997,5525,4276,0,-15,-38,54,92,0,-28.62878
1997,8451,4276,0,-3,-15,68,83,0,-16.910115
1997,9777,4276,0,-1,-13,59,72,0,-12.576272
1997,10032,4526,0,9,10,101,91,1,13.179731
1997,4987,4608,0,-5,-8,57,65,0,-0.71445
1997,6092,4608,0,3,-1,63,64,0,3.15671
1997,6293,4608,0,5,23,97,74,1,11.928166
1997,8894,4608,0,-4,-15,63,78,0,1.014797
1997,7179,4885,0,-3,22,81,59,1,-1.61481
1997,1621,4953,0,-7,9,75,66,1,-14.242941
1997,4608,4987,0,5,8,65,57,1,0.71445
1997,1528,5190,0,9,12,68,56,1,8.60148
1997,1528,5292,0,-3,-6,84,90,0,-5.176121
1997,4276,5292,0,0,9,78,69,1,6.885009
1997,8758,5292,0,-8,-19,57,76,0,-8.259578
1997,8962,5292,0,-15,-32,46,78,0,-30.382372
1997,9414,5292,0,-1,-8,72,80,0,-6.979719
1997,8758,5326,0,-1,22,62,40,1,2.216555
1997,4276,5525,0,15,38,92,54,1,28.62878
1997,2352,5761,0,13,3,71,68,1,29.864277
1997,9777,5862,0,13,14,75,61,1,21.072132
1997,4608,6092,0,-3,1,64,63,1,-3.15671
1997,6744,6092,0,-11,-4,55,59,0,-11.36037
1997,300,6293,0,-3,8,66,58,1,-2.209321
1997,1151,6293,0,-4,-6,57,63,0,-6.314894
1997,1689,6293,0,-8,-17,56,73,0,-14.515564
1997,2721,6293,0,-15,-8,74,82,0,-29.699102
1997,4608,6293,0,-5,-23,74,97,0,-11.928166
1997,8587,6676,0,5,13,80,67,1,5.331862
1997,6092,6744,0,11,4,59,55,1,11.36037
1997,8451,6876,0,9,10,75,65,1,3.877792
1997,1151,7145,0,7,3,55,52,1,10.46352
1997,300,7179,0,6,4,96,92,1,8.78639
1997,1392,7179,0,-4,-6,65,71,0,-11.772184
1997,2352,7179,0,8,-11,87,98,0,11.729485
1997,4885,7179,0,3,-22,59,81,0,1.61481
1997,4161,7213,0,7,14,75,61,1,15.884346
1997,7301,7213,0,-1,-7,76,83,0,5.2297
1997,7213,7301,0,1,7,83,76,1,-5.2297
1997,300,8105,0,9,8,65,57,1,17.711386
1997,1824,8139,0,-13,13,78,65,1,-18.688896
1997,776,8451,0,-1,-4,77,81,0,-1.104403
1997,4276,8451,0,3,15,83,68,1,16.910115
1997,6876,8451,0,-9,-10,65,75,0,-3.877792
1997,10344,8519,0,11,22,68,46,1,18.30236
1997,6676,8587,0,-5,-13,67,80,0,-5.331862
1997,9777,8587,0,4,5,82,77,1,-2.244405
1997,10344,8587,0,3,-6,66,72,0,2.363987
1997,5292,8758,0,8,19,76,57,1,8.259578
1997,5326,8758,0,1,-22,40,62,0,-2.216555
1997,1824,8894,0,-5,-1,81,82,0,-15.668481
1997,4608,8894,0,4,15,78,63,1,-1.014797
1997,10676,8894,0,3,-13,58,71,0,0.73481
1997,5292,8962,0,15,32,78,46,1,30.382372
1997,810,9179,0,-7,-29,52,81,0,-11.344906
1997,1528,9179,0,1,6,65,59,1,3.079321
1997,1324,9414,0,-13,-34,75,109,0,-22.355792
1997,3966,9414,0,-4,-1,73,74,0,-3.158059
1997,5292,9414,0,1,8,80,72,1,6.979719
1997,10798,9414,0,-5,-13,83,96,0,0.597371
1997,3757,9675,0,5,13,90,77,1,1.957548
1997,1358,9777,0,-5,-19,58,77,0,-6.159596
1997,4276,9777,0,1,13,72,59,1,12.576272
1997,5862,9777,0,-13,-14,61,75,0,-21.072132
1997,8587,9777,0,-4,-5,77,82,0,2.244405
1997,776,9930,0,7,7,73,66,1,8.020938
1997,10798,9964,0,3,12,80,68,1,4.262781
1997,1151,10032,0,-1,7,75,68,1,0.714953
1997,4526,10032,0,-9,-10,91,101,0,-13.179731
1997,3932,10066,0,1,13,73,60,1,1.195455
1997,8519,10344,0,-11,-22,46,68,0,-18.30236
1997,8587,10344,0,-3,6,72,66,1,-2.363987
1997,8894,10676,0,-3,13,71,58,1,-0.73481
1997,9414,10798,0,5,13,96,83,1,-0.597371
1997,9964,10798,0,-3,-12,68,80,0,-4.262781
1998,3792,301,0,-8,-33,49,82,0,-14.042689
1998,4954,301,0,-3,-8,79,87,0,-5.562052
1998,6227,301,0,-15,-39,60,99,0,-29.407363
1998,9778,301,0,-2,25,76,51,1,-9.811931
1998,5991,423,0,-5,-9,65,74,0,-7.450095
1998,9778,423,0,3,6,75,69,1,-1.587569
1998,6093,1026,0,9,17,79,62,1,9.569648
1998,3724,1359,0,-1,-15,62,77,0,-1.879643
1998,6294,1359,0,7,10,93,83,1,15.182567
1998,6419,1461,0,-13,-3,62,65,0,-12.165712
1998,10481,1461,0,-8,1,75,74,1,-2.925948
1998,10271,1529,0,-5,3,75,72,1,-7.07113
1998,8588,1622,0,11,10,67,57,1,13.956222
1998,2688,1792,0,-13,-8,85,93,0,-18.654967
1998,3831,1792,0,-5,-10,68,78,0,-6.90697
1998,6294,1792,0,1,11,75,64,1,5.710395
1998,10379,1792,0,-9,-1,74,75,0,-12.142114
1998,5225,2061,0,11,19,80,61,1,19.695452
1998,7214,2129,0,13,39,95,56,1,21.373759
1998,7214,2251,0,8,15,80,65,1,10.116101
1998,8418,2251,0,3,-2,64,66,0,1.110894
1998,4277,2353,0,-1,2,86,84,1,-8.152427
1998,6711,2353,0,-7,-6,73,79,0,-16.78535
1998,7268,2353,0,-15,-36,63,99,0,-35.272098
1998,8675,2353,0,-4,-13,67,80,0,-19.079726
1998,5259,2489,0,9,12,83,71,1,11.913976
1998,1792,2688,0,13,8,93,85,1,18.654967
1998,8725,2891,0,7,-9,87,96,0,9.626774
1998,9931,2891,0,-1,6,83,77,1,-12.980518
1998,6711,3027,0,1,15,74,59,1,3.173475
1998,1359,3724,0,1,15,77,62,1,1.879643
1998,4954,3758,0,1,6,67,61,1,3.775253
1998,8106,3758,0,-7,-13,51,64,0,-7.297671
1998,301,3792,0,8,33,82,49,1,14.042689
1998,8793,3792,0,1,-1,81,82,0,0.732669
1998,1792,3831,0,5,10,78,68,1,6.90697
1998,6677,3831,0,-3,-7,87,94,0,-4.722432
1998,8675,3899,0,7,2,63,61,1,2.744216
1998,7101,4162,0,-15,-58,52,110,0,-38.980863
1998,7302,4162,0,-7,5,80,75,1,-11.163466
1998,2353,4277,0,1,-2,84,86,0,8.152427
1998,7506,4277,0,-13,-15,67,82,0,-28.412811
1998,8486,4277,0,-8,-27,61,88,0,-12.703187
1998,8588,4277,0,-1,-1,85,86,0,-3.975926
1998,9415,4277,0,-4,-26,68,94,0,-9.196808
1998,9778,4277,0,-1,-9,69,78,0,-7.553104
1998,301,4954,0,3,8,87,79,1,5.562052
1998,3758,4954,0,-1,-6,61,67,0,-3.775253
1998,9812,4954,0,-9,-14,68,82,0,-12.703983
1998,8486,4988,0,-3,5,51,46,1,-2.84797
1998,9415,5157,0,5,3,65,62,1,2.313387
1998,2061,5225,0,-11,-19,61,80,0,-19.695452
1998,9415,5225,0,-3,3,85,82,1,-6.047008
1998,2489,5259,0,-9,-12,71,83,0,-11.913976
1998,6294,5259,0,3,15,73,58,1,7.89842
1998,7146,5259,0,-1,-7,56,63,0,-7.710436
1998,9931,5327,0,-9,1,70,69,1,-17.871577
1998,7302,5762,0,1,23,97,74,1,4.029877
1998,6294,5863,0,15,36,88,52,1,30.374766
1998,423,5991,0,5,9,74,65,1,7.450095
1998,1026,6093,0,-9,-17,62,79,0,-9.569648
1998,8675,6093,0,-1,10,56,46,1,-3.612569
1998,301,6227,0,15,39,99,60,1,29.407363
1998,1359,6294,0,-7,-10,83,93,0,-15.182567
1998,1792,6294,0,-1,-11,64,75,0,-5.710395
1998,5259,6294,0,-3,-15,58,73,0,-7.89842
1998,5863,6294,0,-15,-36,52,88,0,-30.374766
1998,9778,6294,0,-2,6,65,59,1,-12.158555
1998,1461,6419,0,13,3,65,62,1,12.165712
1998,3831,6677,0,3,7,94,87,1,4.722432
1998,2353,6711,0,7,6,79,73,1,16.78535
1998,3027,6711,0,-1,-15,59,74,0,-3.173475
1998,4162,7101,0,15,58,110,52,1,38.980863
1998,5259,7146,0,1,7,63,56,1,7.710436
1998,9642,7146,0,-7,-12,57,69,0,-3.929076
1998,2129,7214,0,-13,-39,56,95,0,-21.373759
1998,2251,7214,0,-8,-15,65,80,0,-10.116101
1998,8588,7214,0,-1,8,67,59,1,-2.007037
1998,2353,7268,0,15,36,99,63,1,35.272098
1998,4162,7302,0,7,-5,75,80,0,11.163466
1998,5762,7302,0,-1,-23,74,97,0,-4.029877
1998,8588,7302,0,5,2,79,77,1,6.53859
1998,9931,7302,0,-5,-6,68,74,0,-11.680461
1998,8140,7370,0,11,-1,61,62,0,6.19337
1998,10379,7370,0,3,15,81,66,1,2.467381
1998,4277,7506,0,13,15,82,67,1,28.412811
1998,9778,7739,0,11,17,85,68,1,6.562986
1998,3758,8106,0,7,13,64,51,1,7.297671
1998,7370,8140,0,-11,1,62,61,1,-6.19337
1998,2251,8418,0,-3,2,66,64,1,-1.110894
1998,4277,8486,0,8,27,88,61,1,12.703187
1998,4988,8486,0,3,-5,46,51,0,2.84797
1998,1622,8588,0,-11,-10,57,67,0,-13.956222
1998,4277,8588,0,1,1,86,85,1,3.975926
1998,7214,8588,0,1,-8,59,67,0,2.007037
1998,7302,8588,0,-5,-2,77,79,0,-6.53859
1998,10271,8588,0,-8,-18,65,83,0,-7.705256
1998,2353,8675,0,4,13,80,67,1,19.079726
1998,3899,8675,0,-7,-2,61,63,0,-2.744216
1998,6093,8675,0,1,-10,46,56,0,3.612569
1998,2891,8725,0,-7,9,96,87,1,-9.626774
1998,10481,8759,0,-3,30,82,52,1,1.665059
1998,3792,8793,0,-1,1,82,81,1,-0.732669
1998,4277,9415,0,4,26,94,68,1,9.196808
1998,5157,9415,0,-5,-3,62,65,0,-2.313387
1998,5225,9415,0,3,-3,82,85,0,6.047008
1998,7146,9642,0,7,12,69,57,1,3.929076
1998,301,9778,0,2,-25,51,76,0,9.811931
1998,423,9778,0,-3,-6,69,75,0,1.587569
1998,4277,9778,0,1,9,78,69,1,7.553104
1998,6294,9778,0,2,-6,59,65,0,12.158555
1998,7739,9778,0,-11,-17,68,85,0,-6.562986
1998,10481,9778,0,-7,-3,62,65,0,0.529869
1998,4954,9812,0,9,14,82,68,1,12.703983
1998,2891,9931,0,1,-6,77,83,0,12.980518
1998,5327,9931,0,9,-1,69,70,0,17.871577
1998,7302,9931,0,5,6,74,68,1,11.680461
1998,1529,10271,0,5,-3,72,75,0,7.07113
1998,8588,10271,0,8,18,83,65,1,7.705256
1998,1792,10379,0,9,1,75,74,1,12.142114
1998,7370,10379,0,-3,-15,66,81,0,-2.467381
1998,10799,10379,0,5,-1,68,69,0,11.024949
1998,1461,10481,0,8,-1,74,75,0,2.925948
1998,8759,10481,0,3,-30,52,82,0,-1.665059
1998,9778,10481,0,7,3,65,62,1,-0.529869
1998,10379,10799,0,-5,1,69,68,1,-11.024949
1999,8589,193,0,13,12,69,57,1,26.847207
1999,6678,302,0,-9,1,61,60,1,-3.315016
1999,3934,424,0,-1,10,82,72,1,1.324494
1999,8039,424,0,-9,-14,80,94,0,-11.205118
1999,9779,458,0,13,22,80,58,1,14.661179
1999,6643,527,0,-3,8,72,64,1,-7.665263
1999,6712,527,0,-8,-7,74,81,0,-13.352171
1999,10644,527,0,-15,-39,41,80,0,-31.466095
1999,6678,1360,0,-8,13,85,72,1,1.893959
1999,7303,1360,0,-7,-11,70,81,0,-0.916681
1999,3112,1462,0,-11,-24,48,72,0,-15.282832
1999,8760,1462,0,-3,10,64,54,1,-3.879427
1999,9181,1623,0,-1,9,62,53,1,4.733918
1999,2354,1793,0,0,-3,74,77,0,10.516457
1999,3282,1793,0,-9,-5,62,67,0,-10.911932
1999,3934,1793,0,-4,-10,68,78,0,-10.038767
1999,6094,1793,0,-8,-22,56,78,0,-16.754575
1999,6643,1793,0,-3,-6,58,64,0,-7.084228
1999,9745,1793,0,-15,-25,66,91,0,-31.473332
1999,4610,1894,0,3,-4,58,62,0,4.111594
1999,4955,1894,0,8,12,75,63,1,15.506775
1999,8794,2130,0,9,10,62,52,1,14.061297
1999,6643,2252,0,8,31,75,44,1,9.343961
1999,9416,2252,0,7,-3,53,56,0,7.674017
1999,1793,2354,0,0,3,77,74,1,-10.516457
1999,2827,2354,0,-15,-41,58,99,0,-50.118231
1999,5260,2354,0,0,-6,62,68,0,-12.809057
1999,5459,2354,0,-11,-17,61,78,0,-23.35187
1999,8760,2354,0,-5,-21,64,85,0,-19.015138
1999,9181,2354,0,-8,-41,56,97,0,-24.107653
1999,4163,2655,0,5,21,95,74,1,9.808662
1999,3282,2793,0,-4,1,73,72,1,-2.335817
1999,6912,2793,0,-5,-14,61,75,0,-9.621803
1999,10448,2793,0,-8,-8,74,82,0,-11.456338
1999,2354,2827,0,15,41,99,58,1,50.118231
1999,3832,3028,0,5,20,108,88,1,5.917983
1999,1462,3112,0,11,24,72,48,1,15.282832
1999,1793,3282,0,9,5,67,62,1,10.911932
1999,2793,3282,0,4,-1,72,73,0,2.335817
1999,5294,3282,0,3,-12,63,75,0,0.069927
1999,8589,3282,0,8,-8,74,82,0,9.603819
1999,3028,3832,0,-5,-20,88,108,0,-5.917983
1999,8419,3832,0,3,25,86,61,1,4.640993
1999,424,3934,0,1,-10,72,82,0,-1.324494
1999,1793,3934,0,4,10,78,68,1,10.038767
1999,9283,3934,0,-7,-13,64,77,0,-5.620967
1999,2655,4163,0,-5,-21,74,95,0,-9.808662
1999,4278,4163,0,3,4,92,88,1,7.59831
1999,8760,4244,0,5,7,61,54,1,9.255589
1999,4163,4278,0,-3,-4,88,92,0,-7.59831
1999,5192,4278,0,-7,-15,43,58,0,-12.090098
1999,5260,4278,0,2,7,73,66,1,-0.78357
1999,6128,4278,0,-11,-22,60,82,0,-20.746859
1999,5158,4346,0,13,21,75,54,1,19.880587
1999,1894,4610,0,-3,4,62,58,1,-4.111594
1999,1894,4955,0,-8,-12,63,75,0,-15.506775
1999,8419,4955,0,-1,14,76,62,1,-5.032636
1999,9932,4955,0,-13,-22,60,82,0,-22.611317
1999,4346,5158,0,-13,-21,54,75,0,-19.880587
1999,7215,5158,0,-8,10,73,63,1,-4.143796
1999,4278,5192,0,7,15,58,43,1,12.090098
1999,9779,5192,0,8,-8,58,66,0,7.100821
1999,10380,5192,0,3,-1,58,59,0,0.860822
1999,2354,5260,0,0,6,68,62,1,12.809057
1999,4278,5260,0,-2,-7,66,73,0,0.78357
1999,5328,5260,0,-8,-8,66,74,0,-7.224536
1999,5695,5260,0,-15,-23,53,76,0,-30.039762
1999,6678,5260,0,-12,-8,46,54,0,-9.926674
1999,3282,5294,0,-3,12,75,63,1,-0.069927
1999,5260,5328,0,8,8,74,66,1,7.224536
1999,10034,5328,0,1,-2,70,72,0,-3.073442
1999,6094,5396,0,-1,2,61,59,1,-4.399315
1999,2354,5459,0,11,17,78,61,1,23.35187
1999,8794,5459,0,8,-30,51,81,0,3.759246
1999,10678,5459,0,7,-11,32,43,0,5.637765
1999,5260,5695,0,15,23,76,53,1,30.039762
1999,6643,5763,0,9,14,72,58,1,10.813023
1999,1793,6094,0,8,22,78,56,1,16.754575
1999,5396,6094,0,1,-2,59,61,0,4.399315
1999,4278,6128,0,11,22,82,60,1,20.746859
1999,10448,6295,0,-11,2,76,74,1,-12.639446
1999,527,6643,0,3,-8,64,72,0,7.665263
1999,1793,6643,0,3,6,64,58,1,7.084228
1999,2252,6643,0,-8,-31,44,75,0,-9.343961
1999,5763,6643,0,-9,-14,58,72,0,-10.813023
1999,8419,6643,0,1,-3,74,77,0,4.268285
1999,302,6678,0,9,-1,60,61,0,3.315016
1999,1360,6678,0,8,-13,72,85,0,-1.893959
1999,5260,6678,0,12,8,54,46,1,9.926674
1999,527,6712,0,8,7,81,74,1,13.352171
1999,8676,6712,0,1,-8,61,69,0,4.433994
1999,2793,6912,0,5,14,75,61,1,9.621803
1999,5158,7215,0,8,-10,63,73,0,4.143796
1999,8760,7215,0,4,22,77,55,1,3.100737
1999,8896,7215,0,3,-4,54,58,0,-2.881347
1999,1360,7303,0,7,11,81,70,1,0.916681
1999,8419,7639,0,11,26,69,43,1,21.51973
1999,424,8039,0,9,14,94,80,1,11.205118
1999,3832,8419,0,-3,-25,61,86,0,-4.640993
1999,4955,8419,0,1,-14,62,76,0,5.032636
1999,6643,8419,0,-1,3,77,74,1,-4.268285
1999,7639,8419,0,-11,-26,43,69,0,-21.51973
1999,193,8589,0,-13,-12,57,69,0,-26.847207
1999,3282,8589,0,-8,8,82,74,1,-9.603819
1999,6712,8676,0,-1,8,69,61,1,-4.433994
1999,1462,8760,0,3,-10,54,64,0,3.879427
1999,2354,8760,0,5,21,85,64,1,19.015138
1999,4244,8760,0,-5,-7,54,61,0,-9.255589
1999,7215,8760,0,-4,-22,55,77,0,-3.100737
1999,2130,8794,0,-9,-10,52,62,0,-14.061297
1999,5459,8794,0,-8,30,81,51,1,-3.759246
1999,7215,8896,0,-3,4,58,54,1,2.881347
1999,1623,9181,0,1,-9,53,62,0,-4.733918
1999,2354,9181,0,8,41,97,56,1,24.107653
1999,3934,9283,0,7,13,77,64,1,5.620967
1999,2252,9416,0,-7,3,56,53,1,-7.674017
1999,1793,9745,0,15,25,91,66,1,31.473332
1999,458,9779,0,-13,-22,58,80,0,-14.661179
1999,5192,9779,0,-8,8,66,58,1,-7.100821
1999,4955,9932,0,13,22,82,60,1,22.611317
1999,5328,10034,0,-1,2,72,70,1,3.073442
1999,5192,10380,0,-3,1,59,58,1,-0.860822
1999,2793,10448,0,8,8,82,74,1,11.456338
1999,6295,10448,0,11,-2,74,76,0,12.639446
1999,527,10644,0,15,39,80,41,1,31.466095
1999,5459,10678,0,-7,11,43,32,1,-5.637765
2000,6644,269,0,11,26,87,61,1,14.851876
2000,4039,303,0,-15,-24,47,71,0,-31.981842
2000,10679,303,0,-7,7,66,59,1,-3.719505
2000,5159,425,0,5,4,75,71,1,-1.71744
2000,1895,528,0,-3,-3,69,72,0,-5.836144
2000,3969,528,0,5,19,79,60,1,4.319462
2000,9417,603,0,5,8,65,57,1,6.937826
2000,2794,1028,0,7,1,69,68,1,11.202767
2000,3969,1293,0,13,10,88,78,1,18.503039
2000,9182,1463,0,-5,8,69,61,1,-6.067441
2000,9610,1463,0,-13,-17,47,64,0,-23.127779
2000,8795,1794,0,1,14,65,51,1,2.167052
2000,9814,1794,0,-7,-8,67,75,0,-8.387051
2000,528,1895,0,3,3,72,69,1,5.836144
2000,7216,2097,0,5,1,62,61,1,6.795833
2000,4164,2219,0,1,4,81,77,1,2.950624
2000,2794,2355,0,-4,9,87,78,1,-3.167596
2000,4164,2355,0,-7,-5,64,69,0,-8.329545
2000,4381,2355,0,-15,-27,55,82,0,-32.570825
2000,1028,2794,0,-7,-1,68,69,0,-11.202767
2000,2355,2794,0,4,-9,78,87,0,3.167596
2000,3760,2794,0,1,-17,76,93,0,-2.582917
2000,5261,2794,0,4,13,89,76,1,1.220996
2000,6296,2794,0,-3,-12,59,71,0,-7.098766
2000,6713,2794,0,2,-12,65,77,0,-2.638723
2000,10679,2961,0,1,10,66,56,1,6.641731
2000,4611,3283,0,3,-11,66,77,0,-0.635574
2000,7216,3283,0,4,9,75,66,1,0.545568
2000,8420,3283,0,8,-6,76,82,0,-1.708079
2000,6713,3506,0,11,20,86,66,1,14.972522
2000,2794,3760,0,-1,17,93,76,1,2.582917
2000,6913,3760,0,-9,-10,58,68,0,-16.571581
2000,6981,3833,0,-5,20,77,57,1,-8.090901
2000,8897,3867,0,7,16,77,61,1,13.824205
2000,4956,3901,0,11,15,74,59,1,20.727805
2000,528,3969,0,-5,-19,60,79,0,-4.319462
2000,1293,3969,0,-13,-10,78,88,0,-18.503039
2000,5261,3969,0,1,11,75,64,1,5.743726
2000,9417,3969,0,-4,-24,56,80,0,-3.708729
2000,303,4039,0,15,24,71,47,1,31.981842
2000,2219,4164,0,-1,-4,77,81,0,-2.950624
2000,2355,4164,0,7,5,69,64,1,8.329545
2000,8318,4279,0,-7,-5,80,85,0,-9.512345
2000,8677,4279,0,1,2,52,50,1,-1.224943
2000,8761,4347,0,13,26,73,47,1,20.330065
2000,2355,4381,0,15,27,82,55,1,32.570825
2000,3283,4611,0,-3,11,77,66,1,0.635574
2000,7930,4747,0,-9,-3,61,64,0,-15.7008
2000,8897,4747,0,-1,-5,67,72,0,0.938823
2000,10679,4747,0,-4,13,61,48,1,-3.83914
2000,3901,4956,0,-11,-15,59,74,0,-20.727805
2000,9417,4956,0,-3,35,105,70,1,-4.346052
2000,425,5159,0,-5,-4,71,75,0,1.71744
2000,6644,5159,0,3,-13,62,75,0,6.915375
2000,9182,5159,0,-1,9,80,71,1,8.399029
2000,2794,5261,0,-4,-13,76,89,0,-1.220996
2000,3969,5261,0,-1,-11,64,75,0,-5.743726
2000,8677,5261,0,-3,-17,58,75,0,-6.547224
2000,9780,5261,0,-7,-12,61,73,0,-12.198385
2000,9933,5261,0,-15,-27,38,65,0,-27.246742
2000,10679,5261,0,-7,-12,41,53,0,-8.444223
2000,6296,5397,0,1,14,84,70,1,2.988219
2000,2794,6296,0,3,12,71,59,1,7.098766
2000,5397,6296,0,-1,-14,70,84,0,-2.988219
2000,8590,6296,0,7,-7,53,60,0,11.033049
2000,8795,6296,0,4,-5,69,74,0,3.320439
2000,9182,6296,0,1,-4,55,59,0,3.33565
2000,8420,6421,0,13,5,61,56,1,10.303019
2000,269,6644,0,-11,-26,61,87,0,-14.851876
2000,5159,6644,0,-3,13,75,62,1,-6.915375
2000,7216,6679,0,-3,4,66,62,1,-2.721548
2000,10645,6679,0,-11,-24,50,74,0,-20.175634
2000,2794,6713,0,-2,12,77,65,1,2.638723
2000,3506,6713,0,-11,-20,66,86,0,-14.972522
2000,6981,6713,0,-8,-8,67,75,0,-8.186946
2000,7974,6713,0,-7,-2,66,68,0,-10.686793
2000,7974,6811,0,-3,1,72,71,1,-5.305565
2000,3760,6913,0,9,10,68,58,1,16.571581
2000,3833,6981,0,5,-20,57,77,0,8.090901
2000,6713,6981,0,8,8,75,67,1,8.186946
2000,2097,7216,0,-5,-1,61,62,0,-6.795833
2000,3283,7216,0,-4,-9,66,75,0,-0.545568
2000,6679,7216,0,3,-4,62,66,0,2.721548
2000,10679,7216,0,-2,4,64,60,1,-0.826312
2000,8590,7508,0,15,19,84,65,1,38.033632
2000,8677,7640,0,9,14,79,65,1,14.567414
2000,4747,7930,0,9,3,64,61,1,15.7008
2000,6713,7974,0,7,2,68,66,1,10.686793
2000,6811,7974,0,3,-1,71,72,0,5.305565
2000,8761,7974,0,8,-2,65,67,0,11.218125
2000,4279,8318,0,7,5,85,80,1,9.512345
2000,3283,8420,0,-8,6,82,76,1,1.708079
2000,6421,8420,0,-13,-5,56,61,0,-10.303019
2000,9780,8488,0,1,3,48,45,1,2.793953
2000,6296,8590,0,-7,7,60,53,1,-11.033049
2000,7508,8590,0,-15,-19,65,84,0,-38.033632
2000,4279,8677,0,-1,-2,50,52,0,1.224943
2000,5261,8677,0,3,17,75,58,1,6.547224
2000,7640,8677,0,-9,-14,65,79,0,-14.567414
2000,4347,8761,0,-13,-26,47,73,0,-20.330065
2000,7974,8761,0,-8,2,67,65,1,-11.218125
2000,1794,8795,0,-1,-14,51,65,0,-2.167052
2000,6296,8795,0,-4,5,74,69,1,-3.320439
2000,9451,8795,0,-9,-5,58,63,0,-17.40291
2000,3867,8897,0,-7,-16,61,77,0,-13.824205
2000,4747,8897,0,1,5,72,67,1,-0.938823
2000,1463,9182,0,5,-8,61,69,0,6.067441
2000,5159,9182,0,1,-9,71,80,0,-8.399029
2000,6296,9182,0,-1,4,59,55,1,-3.33565
2000,9644,9182,0,-3,-27,62,89,0,-9.183913
2000,603,9417,0,-5,-8,57,65,0,-6.937826
2000,3969,9417,0,4,24,80,56,1,3.708729
2000,4956,9417,0,3,-35,70,105,0,4.346052
2000,8795,9451,0,9,5,63,58,1,17.40291
2000,1463,9610,0,13,17,64,47,1,23.127779
2000,9182,9644,0,3,27,89,62,1,9.183913
2000,5261,9780,0,7,12,73,61,1,12.198385
2000,8488,9780,0,-1,-3,45,48,0,-2.793953
2000,1794,9814,0,7,8,75,67,1,8.387051
2000,5261,9933,0,15,27,65,38,1,27.246742
2000,6679,10645,0,11,24,74,50,1,20.175634
2000,303,10679,0,7,-7,59,66,0,3.719505
2000,2961,10679,0,-1,-10,56,66,0,-6.641731
2000,4747,10679,0,4,-13,48,61,0,3.83914
2000,5261,10679,0,7,12,53,41,1,8.444223
2000,7216,10679,0,2,-4,60,64,0,0.826312
2001,5262,142,0,15,34,69,35,1,34.202451
2001,1029,304,0,-8,-21,52,73,0,-14.31151
2001,2356,304,0,1,10,82,72,1,6.557891
2001,2424,304,0,-13,-25,76,101,0,-24.997189
2001,3761,304,0,1,-6,81,87,0,-3.595826
2001,5262,304,0,1,-19,61,80,0,-0.480611
2001,5330,304,0,-1,-10,56,66,0,-10.155548
2001,3148,426,0,-3,2,63,61,1,-5.475931
2001,8285,780,0,-11,-3,65,68,0,-16.203574
2001,9679,780,0,-3,3,74,71,1,-3.203125
2001,304,1029,0,8,21,73,52,1,14.31151
2001,10348,1029,0,3,-16,63,79,0,9.931976
2001,1464,1063,0,7,25,84,59,1,3.404909
2001,2962,1155,0,-1,12,82,70,1,0.611333
2001,3761,1362,0,8,18,79,61,1,8.251491
2001,8796,1362,0,1,-7,63,70,0,2.128246
2001,1063,1464,0,-7,-25,59,84,0,-3.404909
2001,4246,1464,0,-8,-23,43,66,0,-6.349891
2001,8591,1464,0,4,13,78,65,1,11.179872
2001,3936,1896,0,3,13,69,56,1,1.070893
2001,4165,1969,0,9,24,99,75,1,13.590324
2001,304,2356,0,-1,-10,72,82,0,-6.557891
2001,4957,2356,0,-2,-11,84,95,0,-8.259693
2001,5398,2356,0,-8,-13,81,94,0,-22.000343
2001,5495,2356,0,-15,-43,52,95,0,-36.051917
2001,9418,2356,0,-3,-13,63,76,0,-16.184186
2001,9679,2356,0,-5,-10,69,79,0,-16.977899
2001,304,2424,0,13,25,101,76,1,24.997189
2001,8762,2795,0,-8,21,75,54,1,-8.03196
2001,10240,2795,0,-11,-13,56,69,0,-13.855523
2001,1155,2962,0,1,-12,70,82,0,-0.611333
2001,5262,2962,0,8,16,81,65,1,9.914938
2001,4957,3114,0,11,3,83,80,1,19.783052
2001,426,3148,0,3,-2,61,63,0,5.475931
2001,3346,3148,0,-5,-19,57,76,0,-16.096579
2001,4957,3148,0,7,10,76,66,1,12.448198
2001,5398,3182,0,-1,2,70,68,1,-2.833858
2001,4957,3216,0,8,19,79,60,1,19.223281
2001,10680,3216,0,5,-1,49,50,0,10.116637
2001,8455,3250,0,-1,4,66,62,1,-2.917327
2001,3868,3284,0,-1,-17,68,85,0,-4.722594
2001,5262,3284,0,11,15,77,62,1,13.551229
2001,10070,3284,0,7,-1,85,86,0,7.632056
2001,3148,3346,0,5,19,76,57,1,16.096579
2001,3970,3346,0,13,-1,57,58,0,21.072731
2001,8678,3454,0,7,10,79,69,1,4.636127
2001,9418,3507,0,9,13,61,48,1,11.240412
2001,4280,3541,0,13,4,72,68,1,22.193798
2001,304,3761,0,-1,6,87,81,1,3.595826
2001,1362,3761,0,-8,-18,61,79,0,-8.251491
2001,4165,3761,0,-3,-16,64,80,0,-2.522194
2001,6524,3761,0,-15,-42,54,96,0,-33.415918
2001,4246,3834,0,-9,4,77,73,1,-9.144951
2001,3284,3868,0,1,17,85,68,1,4.722594
2001,6680,3868,0,9,-2,68,70,0,8.893049
2001,5330,3902,0,11,2,72,70,1,16.060054
2001,1896,3936,0,-3,-13,56,69,0,-1.070893
2001,4280,3936,0,5,13,92,79,1,7.294967
2001,3346,3970,0,-13,1,58,57,1,-21.072731
2001,1969,4165,0,-9,-24,75,99,0,-13.590324
2001,3761,4165,0,3,16,80,64,1,2.522194
2001,8678,4165,0,-1,-29,58,87,0,-8.14223
2001,1464,4246,0,8,23,66,43,1,6.349891
2001,3834,4246,0,9,-4,73,77,0,9.144951
2001,3541,4280,0,-13,-4,68,72,0,-22.193798
2001,3936,4280,0,-5,-13,79,92,0,-7.294967
2001,9679,4280,0,-4,4,80,76,1,-5.777592
2001,2356,4957,0,2,11,95,84,1,8.259693
2001,3114,4957,0,-11,-3,80,83,0,-19.783052
2001,3148,4957,0,-7,-10,66,76,0,-12.448198
2001,3216,4957,0,-8,-19,60,79,0,-19.223281
2001,8591,4957,0,2,-14,73,87,0,1.986155
2001,142,5262,0,-15,-34,35,69,0,-34.202451
2001,304,5262,0,-1,19,80,61,1,0.480611
2001,2962,5262,0,-8,-16,65,81,0,-9.914938
2001,3284,5262,0,-11,-15,62,77,0,-13.551229
2001,8762,5262,0,-10,-7,62,69,0,-10.862754
2001,304,5330,0,1,10,66,56,1,10.155548
2001,3902,5330,0,-11,-2,70,72,0,-16.060054
2001,6558,5330,0,-3,-3,56,59,0,-1.591266
2001,2356,5398,0,8,13,94,81,1,22.000343
2001,3182,5398,0,1,-2,68,70,0,2.833858
2001,2356,5495,0,15,43,95,52,1,36.051917
2001,6948,6297,0,-5,8,82,74,1,-9.0606
2001,7149,6297,0,-13,-22,48,70,0,-23.367417
2001,3761,6524,0,15,42,96,54,1,33.415918
2001,10646,6524,0,0,-4,67,71,0,7.954121
2001,5330,6558,0,3,3,59,56,1,1.591266
2001,10802,6558,0,-5,-12,71,83,0,-1.930815
2001,9815,6645,0,-7,9,77,68,1,-6.047143
2001,3868,6680,0,-9,2,70,68,1,-8.893049
2001,9679,6714,0,5,15,69,54,1,4.124399
2001,6297,6948,0,5,-8,74,82,0,9.0606
2001,7183,6948,0,-3,-10,59,69,0,2.569231
2001,8762,6948,0,-4,12,84,72,1,2.868468
2001,6297,7149,0,13,22,70,48,1,23.367417
2001,6948,7183,0,3,10,69,59,1,-2.569231
2001,780,8285,0,11,3,68,65,1,16.203574
2001,3250,8455,0,1,-4,62,66,0,2.917327
2001,8591,8455,0,8,7,90,83,1,14.027942
2001,1464,8591,0,-4,-13,65,78,0,-11.179872
2001,4957,8591,0,-2,14,87,73,1,-1.986155
2001,8455,8591,0,-8,-7,83,90,0,-14.027942
2001,9577,8591,0,-15,-29,60,89,0,-31.169765
2001,3454,8678,0,-7,-10,69,79,0,-4.636127
2001,4165,8678,0,1,29,87,58,1,8.14223
2001,2795,8762,0,8,-21,54,75,0,8.03196
2001,5262,8762,0,10,7,69,62,1,10.862754
2001,6948,8762,0,4,-12,72,84,0,-2.868468
2001,8898,8762,0,5,-14,65,79,0,0.221899
2001,1362,8796,0,-1,7,70,63,1,-2.128246
2001,8762,8898,0,-5,14,79,65,1,-0.221899
2001,2356,9418,0,3,13,76,63,1,16.184186
2001,3507,9418,0,-9,-13,48,61,0,-11.240412
2001,9815,9418,0,-8,-25,50,75,0,-6.280079
2001,8591,9577,0,15,29,89,60,1,31.169765
2001,780,9679,0,3,-3,71,74,0,3.203125
2001,2356,9679,0,5,10,79,69,1,16.977899
2001,4280,9679,0,4,-4,76,80,0,5.777592
2001,6714,9679,0,-5,-15,54,69,0,-4.124399
2001,6645,9815,0,7,-9,68,77,0,6.047143
2001,9418,9815,0,8,25,75,50,1,6.280079
2001,3284,10070,0,-7,1,86,85,1,-7.632056
2001,2795,10240,0,11,13,69,56,1,13.855523
2001,1029,10348,0,-3,16,79,63,1,-9.931976
2001,6524,10646,0,0,4,71,67,1,-7.954121
2001,3216,10680,0,-5,1,50,49,1,-10.116637
2001,6558,10802,0,5,12,83,71,1,1.930815
2002,2751,90,0,-13,-8,78,86,0,-22.459604
2002,4247,90,0,-8,13,71,58,1,-5.161463
2002,8042,196,0,0,4,81,77,1,8.38465
2002,6681,305,0,1,21,88,67,1,2.76302
2002,7811,305,0,-11,-5,81,86,0,-12.269072
2002,10769,305,0,-8,-8,60,68,0,-9.595172
2002,8899,781,0,5,13,70,57,1,4.646151
2002,1465,815,0,15,38,90,52,1,29.137896
2002,6915,1156,0,-5,-7,75,82,0,-5.966751
2002,7017,1156,0,3,13,63,50,1,0.594835
2002,7017,1295,0,11,17,71,54,1,15.61344
2002,6559,1363,0,1,19,82,63,1,0.569281
2002,815,1465,0,-15,-38,52,90,0,-29.137896
2002,9419,1465,0,-7,4,105,101,1,-12.052957
2002,3347,1796,0,-13,-11,67,78,0,-16.609673
2002,4958,1796,0,1,8,90,82,1,6.367187
2002,5946,1796,0,-5,-3,74,77,0,-0.534317
2002,7557,1796,0,-9,-12,59,71,0,-6.851493
2002,2796,1897,0,7,-1,82,83,0,15.290729
2002,3762,1897,0,8,12,72,60,1,10.700594
2002,6646,2065,0,9,5,69,64,1,16.776392
2002,3835,2357,0,-4,1,74,73,1,-10.577577
2002,6559,2357,0,-7,-7,77,84,0,-13.92535
2002,10647,2357,0,-15,-47,37,84,0,-34.954389
2002,90,2751,0,13,8,86,78,1,22.459604
2002,1897,2796,0,-7,1,83,82,1,-15.290729
2002,5766,3183,0,-11,-17,68,85,0,-14.531095
2002,7557,3183,0,-8,2,77,75,1,-5.907942
2002,10769,3285,0,-5,7,73,66,1,-6.089898
2002,1796,3347,0,13,11,78,67,1,16.609673
2002,10803,3455,0,3,12,70,58,1,3.790503
2002,4166,3542,0,15,11,70,59,1,26.270178
2002,6681,3728,0,13,8,71,63,1,20.021946
2002,1897,3762,0,-8,-12,60,72,0,-10.700594
2002,4166,3762,0,3,4,73,69,1,5.703868
2002,7710,3762,0,-9,-29,64,93,0,-9.912612
2002,2357,3835,0,4,-1,73,74,0,10.577577
2002,4247,3835,0,-5,-12,69,81,0,-5.491528
2002,4958,3835,0,4,12,64,52,1,4.054418
2002,6681,3835,0,3,-9,64,73,0,2.61244
2002,9612,3835,0,-8,-9,67,76,0,-12.833278
2002,9782,3835,0,-7,-19,56,75,0,-6.862661
2002,3542,4166,0,-15,-11,59,70,0,-26.270178
2002,3762,4166,0,-3,-4,69,73,0,-5.703868
2002,4958,4166,0,0,9,97,88,1,-1.816368
2002,6813,4166,0,-1,-18,86,104,0,-3.273937
2002,8592,4166,0,-7,-23,63,86,0,-6.336654
2002,90,4247,0,8,-13,58,71,0,5.161463
2002,3835,4247,0,5,12,81,69,1,5.491528
2002,6715,4247,0,3,-8,61,69,0,1.816334
2002,7017,4247,0,7,-5,73,78,0,1.709099
2002,4958,4281,0,3,10,78,68,1,2.970803
2002,9184,4281,0,-8,-5,82,87,0,-7.016282
2002,9935,4281,0,-9,-15,68,83,0,-9.762552
2002,9184,4890,0,-7,2,71,69,1,-5.24636
2002,1796,4958,0,-1,-8,82,90,0,-6.367187
2002,3835,4958,0,-4,-12,52,64,0,-4.054418
2002,4166,4958,0,0,-9,88,97,0,1.816368
2002,4281,4958,0,-3,-10,68,78,0,-2.970803
2002,8042,4958,0,-15,-15,70,85,0,-25.269562
2002,10681,4958,0,-7,-30,57,87,0,-12.060936
2002,5365,5026,0,11,12,70,58,1,15.551025
2002,5399,5161,0,-7,13,93,80,1,-0.395238
2002,5946,5263,0,3,11,69,58,1,0.230433
2002,9419,5331,0,1,22,80,58,1,-1.896643
2002,5026,5365,0,-11,-12,58,70,0,-15.551025
2002,8899,5365,0,-3,4,68,64,1,-1.152995
2002,5161,5399,0,7,-13,80,93,0,0.395238
2002,6646,5399,0,8,-16,67,83,0,4.02902
2002,6681,5399,0,10,6,81,75,1,7.946733
2002,9419,5399,0,4,-9,73,82,0,-0.20451
2002,6813,5530,0,13,19,81,62,1,25.023601
2002,3183,5766,0,11,17,85,68,1,14.531095
2002,1796,5946,0,5,3,77,74,1,0.534317
2002,5263,5946,0,-3,-11,58,69,0,-0.230433
2002,1363,6559,0,-1,-19,63,82,0,-0.569281
2002,2357,6559,0,7,7,84,77,1,13.92535
2002,2065,6646,0,-9,-5,64,69,0,-16.776392
2002,5399,6646,0,-8,16,83,67,1,-4.02902
2002,305,6681,0,-1,-21,67,88,0,-2.76302
2002,3728,6681,0,-13,-8,63,71,0,-20.021946
2002,3835,6681,0,-3,9,73,64,1,-2.61244
2002,5399,6681,0,-10,-6,75,81,0,-7.946733
2002,10803,6681,0,-5,-13,65,78,0,-7.087751
2002,4247,6715,0,-3,8,69,61,1,-1.816334
2002,4166,6813,0,1,18,104,86,1,3.273937
2002,5530,6813,0,-13,-19,62,81,0,-25.023601
2002,8899,6813,0,-4,-2,70,72,0,-7.039218
2002,10349,6813,0,-5,-5,87,92,0,-5.87497
2002,1156,6915,0,5,7,82,75,1,5.966751
2002,10349,6983,0,3,9,83,74,1,5.849681
2002,1156,7017,0,-3,-13,50,63,0,-0.594835
2002,1295,7017,0,-11,-17,54,71,0,-15.61344
2002,4247,7017,0,-7,5,78,73,1,-1.709099
2002,1796,7557,0,9,12,71,59,1,6.851493
2002,3183,7557,0,8,-2,75,77,0,5.907942
2002,9001,7557,0,5,-8,68,76,0,5.961436
2002,3762,7710,0,9,29,93,64,1,9.912612
2002,305,7811,0,11,5,86,81,1,12.269072
2002,196,8042,0,0,-4,77,81,0,-8.38465
2002,4958,8042,0,15,15,85,70,1,25.269562
2002,10681,8422,0,1,10,80,70,1,2.204887
2002,4166,8592,0,7,23,86,63,1,6.336654
2002,10241,8592,0,-1,-16,68,84,0,-6.902001
2002,781,8899,0,-5,-13,57,70,0,-4.646151
2002,5365,8899,0,3,-4,64,68,0,1.152995
2002,6813,8899,0,4,2,72,70,1,7.039218
2002,7557,9001,0,-5,8,76,68,1,-5.961436
2002,4281,9184,0,8,5,87,82,1,7.016282
2002,4890,9184,0,7,-2,69,71,0,5.24636
2002,1465,9419,0,7,-4,101,105,0,12.052957
2002,5331,9419,0,-1,-22,58,80,0,1.896643
2002,5399,9419,0,-4,9,82,73,1,0.20451
2002,3835,9612,0,8,9,76,67,1,12.833278
2002,9680,9612,0,9,-4,89,93,0,12.072548
2002,9612,9680,0,-9,4,93,89,1,-12.072548
2002,3835,9782,0,7,19,75,56,1,6.862661
2002,4281,9935,0,9,15,83,68,1,9.762552
2002,8592,10241,0,1,16,84,68,1,6.902001
2002,6813,10349,0,5,5,92,87,1,5.87497
2002,6983,10349,0,-3,-9,74,83,0,-5.849681
2002,2357,10647,0,15,47,84,37,1,34.954389
2002,4958,10681,0,7,30,87,57,1,12.060936
2002,8422,10681,0,-1,-10,70,80,0,-2.204887
2002,305,10769,0,8,8,68,60,1,9.595172
2002,3285,10769,0,5,-7,66,73,0,6.089898
2002,3455,10803,0,-3,-12,58,70,0,-3.790503
2002,6681,10803,0,5,13,78,65,1,7.087751
2003,3836,91,0,3,5,67,62,1,-1.027994
2003,3286,306,0,-8,-1,95,96,0,-11.700247
2003,4167,306,0,-1,3,78,75,1,0.999427
2003,6560,306,0,-4,-17,71,88,0,-6.058861
2003,10004,306,0,-15,-29,51,80,0,-24.71522
2003,4167,340,0,8,32,108,76,1,8.941539
2003,5095,340,0,3,-13,71,84,0,-1.660955
2003,8457,531,0,3,-2,63,65,0,2.535582
2003,8680,531,0,7,1,79,78,1,5.261559
2003,10350,531,0,8,-6,62,68,0,5.399253
2003,4614,572,0,9,22,86,64,1,21.260452
2003,4614,1031,0,8,-8,71,79,0,12.613003
2003,5366,1031,0,7,-1,46,47,0,10.230614
2003,6682,1031,0,11,11,65,54,1,11.715781
2003,1797,1065,0,7,5,58,53,1,1.43353
2003,1898,1099,0,5,-6,73,79,0,8.963163
2003,2358,1099,0,8,26,86,60,1,12.50295
2003,5947,1157,0,-1,-2,74,76,0,-0.156571
2003,6682,1157,0,7,9,74,65,1,7.844887
2003,3286,1466,0,-1,5,74,69,1,-1.615983
2003,5264,1695,0,3,15,79,64,1,1.688514
2003,2358,1729,0,11,10,67,57,1,13.953806
2003,1065,1797,0,-7,-5,53,58,0,-1.43353
2003,8593,1797,0,1,-11,74,85,0,-1.643313
2003,8900,1797,0,4,4,82,78,1,4.047506
2003,1099,1898,0,-5,6,79,73,1,-8.963163
2003,9185,2100,0,-9,13,84,71,1,-1.902632
2003,1099,2358,0,-8,-26,60,86,0,-12.50295
2003,1729,2358,0,-11,-10,57,67,0,-13.953806
2003,4167,2358,0,1,4,69,65,1,5.082922
2003,10350,2625,0,13,3,76,73,1,19.342005
2003,5264,2797,0,-5,22,68,46,1,-4.229352
2003,7609,2797,0,-13,-30,55,85,0,-20.218347
2003,306,3286,0,8,1,96,95,1,11.700247
2003,1466,3286,0,1,-5,69,74,0,1.615983
2003,4891,3543,0,11,4,72,68,1,11.544245
2003,6560,3763,0,-1,8,68,60,1,-2.950631
2003,10242,3763,0,-9,-5,60,65,0,-13.025798
2003,91,3836,0,-3,-5,62,67,0,1.027994
2003,7018,3836,0,5,22,74,52,1,8.274432
2003,4282,4008,0,15,31,95,64,1,24.790429
2003,306,4167,0,1,-3,75,78,0,-0.999427
2003,340,4167,0,-8,-32,76,108,0,-8.941539
2003,2358,4167,0,-1,-4,65,69,0,-5.082922
2003,4891,4167,0,-1,-33,61,94,0,-8.026176
2003,8680,4167,0,-1,3,81,78,1,-6.944514
2003,9817,4167,0,-13,-3,61,64,0,-20.922814
2003,4008,4282,0,-15,-31,64,95,0,-24.790429
2003,4891,4282,0,-2,14,83,69,1,-6.355692
2003,9783,4282,0,-8,-20,54,74,0,-11.488822
2003,10682,4282,0,-4,-6,57,63,0,-4.85409
2003,572,4614,0,-9,-22,64,86,0,-21.260452
2003,1031,4614,0,-8,8,79,71,1,-12.613003
2003,7219,4750,0,-1,24,80,56,1,-1.751427
2003,8680,4823,0,11,11,76,65,1,12.235654
2003,3543,4891,0,-11,-4,68,72,0,-11.544245
2003,4167,4891,0,1,33,94,61,1,8.026176
2003,4282,4891,0,2,-14,69,83,0,6.355692
2003,5400,4891,0,-3,-9,92,101,0,-1.06906
2003,7018,4891,0,1,-3,74,77,0,4.648615
2003,5264,4959,0,-1,2,60,58,1,-5.806698
2003,9613,4959,0,-5,-2,73,75,0,-12.724219
2003,10804,4959,0,3,-13,64,77,0,-4.265681
2003,340,5095,0,-3,13,84,71,1,1.660955
2003,1695,5264,0,-3,-15,64,79,0,-1.688514
2003,2797,5264,0,5,-22,46,68,0,4.229352
2003,4959,5264,0,1,-2,58,60,0,5.806698
2003,8900,5264,0,6,9,85,76,1,4.414986
2003,1031,5366,0,-7,1,47,46,1,-10.230614
2003,4891,5400,0,3,9,101,92,1,1.06906
2003,7558,5400,0,-5,-1,71,72,0,-6.89235
2003,1157,5947,0,1,2,76,74,1,0.156571
2003,306,6560,0,4,17,88,71,1,6.058861
2003,3763,6560,0,1,-8,60,68,0,2.950631
2003,10548,6560,0,-7,-1,69,70,0,-10.142328
2003,1031,6682,0,-11,-11,54,65,0,-11.715781
2003,1157,6682,0,-7,-9,65,74,0,-7.844887
2003,7511,6682,0,-15,-17,54,71,0,-29.319476
2003,8680,6682,0,-2,16,63,47,1,-2.213388
2003,6916,6716,0,-5,-14,63,77,0,-6.006598
2003,8680,6716,0,3,12,68,56,1,2.760303
2003,9783,6814,0,-1,2,60,58,1,-3.030815
2003,6716,6916,0,5,14,77,63,1,6.006598
2003,3836,7018,0,-5,-22,52,74,0,-8.274432
2003,4891,7018,0,-1,3,77,74,1,-4.648615
2003,10316,7018,0,-13,-26,61,87,0,-24.490408
2003,4750,7219,0,1,-24,56,80,0,1.751427
2003,8900,7219,0,8,10,77,67,1,4.026171
2003,6682,7511,0,15,17,71,54,1,29.319476
2003,5400,7558,0,5,1,72,71,1,6.89235
2003,2797,7609,0,13,30,85,55,1,20.218347
2003,8593,7677,0,9,8,77,69,1,8.254935
2003,531,8457,0,-3,2,65,63,1,-2.535582
2003,1797,8593,0,-1,11,85,74,1,1.643313
2003,7677,8593,0,-9,-8,69,77,0,-8.254935
2003,531,8680,0,-7,-1,78,79,0,-5.261559
2003,4167,8680,0,1,-3,78,81,0,6.944514
2003,4823,8680,0,-11,-11,65,76,0,-12.235654
2003,6682,8680,0,2,-16,47,63,0,2.213388
2003,6716,8680,0,-3,-12,56,68,0,-2.760303
2003,8900,8680,0,2,-11,84,95,0,1.839119
2003,1797,8900,0,-4,-4,78,82,0,-4.047506
2003,5264,8900,0,-6,-9,76,85,0,-4.414986
2003,7219,8900,0,-8,-10,67,77,0,-4.026171
2003,8680,8900,0,-2,11,95,84,1,-1.839119
2003,9552,8900,0,-15,-21,61,82,0,-33.274432
2003,10804,9121,0,11,12,71,59,1,13.778263
2003,2100,9185,0,9,-13,71,84,0,1.902632
2003,10682,9185,0,8,1,61,60,1,8.297428
2003,9552,9253,0,0,8,92,84,1,-5.001605
2003,8900,9552,0,15,21,82,61,1,33.274432
2003,9253,9552,0,0,-8,84,92,0,5.001605
2003,4959,9613,0,5,2,75,73,1,12.724219
2003,4282,9783,0,8,20,74,54,1,11.488822
2003,6814,9783,0,1,-2,58,60,0,3.030815
2003,4167,9817,0,13,3,64,61,1,20.922814
2003,306,10004,0,15,29,80,51,1,24.71522
2003,3763,10242,0,9,5,65,60,1,13.025798
2003,7018,10316,0,13,26,87,61,1,24.490408
2003,531,10350,0,-8,6,68,62,1,-5.399253
2003,2625,10350,0,-13,-3,73,76,0,-19.342005
2003,10682,10452,0,7,7,81,74,1,13.541812
2003,6560,10548,0,7,1,70,69,1,10.142328
2003,4282,10682,0,4,6,63,57,1,4.85409
2003,9185,10682,0,-8,-1,60,61,0,-8.297428
2003,10452,10682,0,-7,-7,74,81,0,-13.541812
2003,4959,10804,0,-3,13,77,64,1,4.265681
2003,9121,10804,0,-11,-12,59,71,0,-13.778263
2004,6300,24,0,5,11,63,52,1,10.455109
2004,1798,92,0,6,16,87,71,1,7.161052
2004,7559,92,0,-1,-1,64,65,0,-4.027119
2004,8594,92,0,7,-3,67,70,0,3.260401
2004,8681,92,0,3,-9,71,80,0,-1.903278
2004,2359,145,0,15,35,96,61,1,37.03129
2004,7978,307,0,1,4,80,76,1,-1.192892
2004,3253,783,0,3,3,57,54,1,9.863753
2004,9784,783,0,-5,-7,51,58,0,0.25158
2004,8681,1066,0,7,5,80,75,1,-0.461294
2004,9003,1365,0,1,3,76,73,1,2.042486
2004,2626,1467,0,-9,-3,77,80,0,-16.411821
2004,3764,1467,0,-1,24,92,68,1,-4.665881
2004,92,1798,0,-6,-16,71,87,0,-7.161052
2004,2223,1798,0,-5,-17,55,72,0,-12.433218
2004,2359,1798,0,1,-1,78,79,0,4.154157
2004,3253,1798,0,-1,-9,73,82,0,-0.310542
2004,9971,1798,0,-4,-20,53,73,0,-5.589513
2004,10005,1798,0,-13,-17,53,70,0,-24.721518
2004,2223,2101,0,3,7,76,69,1,2.167413
2004,1798,2223,0,5,17,72,55,1,12.433218
2004,2101,2223,0,-3,-7,69,76,0,-2.167413
2004,145,2359,0,-15,-35,61,96,0,-37.03129
2004,1798,2359,0,-1,1,79,78,1,-4.154157
2004,3764,2359,0,-4,-10,62,72,0,-10.315938
2004,7978,2359,0,-7,-28,62,90,0,-11.391931
2004,10805,2359,0,-6,-3,63,66,0,-13.707724
2004,6717,2529,0,13,19,75,56,1,19.270737
2004,1467,2626,0,9,3,80,77,1,16.411821
2004,4824,2798,0,-7,15,75,60,1,-9.421724
2004,4283,2832,0,15,20,96,76,1,30.649473
2004,4419,2832,0,0,-15,57,72,0,4.161295
2004,783,3253,0,-3,-3,54,57,0,-9.863753
2004,1798,3253,0,1,9,82,73,1,0.310542
2004,4168,3253,0,-1,-8,71,79,0,-5.664951
2004,6031,3253,0,-7,-5,67,72,0,-7.3939
2004,6459,3253,0,-11,-5,60,65,0,-14.975392
2004,6717,3253,0,1,-2,65,67,0,-1.220991
2004,6031,3287,0,-8,19,91,72,1,-5.618723
2004,9937,3287,0,-13,-27,49,76,0,-19.395637
2004,4168,3730,0,9,25,78,53,1,9.480504
2004,1467,3764,0,1,-24,68,92,0,4.665881
2004,2359,3764,0,4,10,72,62,1,10.315938
2004,5768,3764,0,-7,-19,53,72,0,-7.884707
2004,3253,4168,0,1,8,79,71,1,5.664951
2004,3730,4168,0,-9,-25,53,78,0,-9.480504
2004,6883,4168,0,-8,-15,63,78,0,-10.350493
2004,9288,4168,0,-5,-26,74,100,0,-3.272155
2004,2832,4283,0,-15,-20,76,96,0,-30.649473
2004,9288,4283,0,-8,1,76,75,1,-7.412656
2004,2832,4419,0,0,15,72,57,1,-4.161295
2004,8458,4449,0,15,19,82,63,1,23.166685
2004,10805,4615,0,3,10,80,70,1,-7.326536
2004,2798,4824,0,7,-15,60,75,0,9.421724
2004,10351,4824,0,8,4,84,80,1,11.378771
2004,8681,4960,0,-1,2,72,70,1,-4.941928
2004,9866,4960,0,-9,-3,83,86,0,-6.323815
2004,6717,5096,0,5,17,70,53,1,7.118201
2004,8146,5096,0,-3,-16,43,59,0,0.623496
2004,6031,5265,0,-3,6,72,66,1,2.067938
2004,5498,5367,0,-13,-33,52,85,0,-21.901105
2004,10805,5367,0,-5,15,89,74,1,-5.226673
2004,5367,5498,0,13,33,85,52,1,21.901105
2004,3764,5768,0,7,19,72,53,1,7.884707
2004,9455,5948,0,-11,-9,52,61,0,-12.711855
2004,9971,5948,0,-3,2,75,73,1,-2.825915
2004,3253,6031,0,7,5,72,67,1,7.3939
2004,3287,6031,0,8,-19,72,91,0,5.618723
2004,5265,6031,0,3,-6,66,72,0,-2.067938
2004,24,6300,0,-5,-11,52,63,0,-10.455109
2004,8901,6300,0,3,3,78,75,1,-1.127671
2004,3253,6459,0,11,5,65,60,1,14.975392
2004,2529,6717,0,-13,-19,56,75,0,-19.270737
2004,3253,6717,0,-1,2,67,65,1,1.220991
2004,5096,6717,0,-5,-17,53,70,0,-7.118201
2004,7019,6717,0,-1,-12,51,63,0,-1.813361
2004,8458,6717,0,1,-2,62,64,0,-0.239454
2004,4168,6883,0,8,15,78,63,1,10.350493
2004,7186,6883,0,7,-8,58,66,0,9.824938
2004,6717,7019,0,1,12,63,51,1,1.813361
2004,9387,7019,0,-11,-9,44,53,0,-16.541502
2004,10683,7019,0,-3,-4,55,59,0,0.232003
2004,8901,7152,0,11,17,66,49,1,17.147527
2004,6883,7186,0,-7,8,66,58,1,-9.824938
2004,10683,7376,0,5,12,76,64,1,8.601358
2004,92,7559,0,1,1,65,64,1,4.027119
2004,307,7978,0,-1,-4,76,80,0,1.192892
2004,2359,7978,0,7,28,90,62,1,11.391931
2004,5096,8146,0,3,16,59,43,1,-0.623496
2004,4449,8458,0,-15,-19,63,82,0,-23.166685
2004,6717,8458,0,-1,2,64,62,1,0.239454
2004,9003,8458,0,-7,-5,65,70,0,-5.40616
2004,10351,8458,0,-3,-4,80,84,0,-0.513394
2004,92,8594,0,-7,3,70,67,1,-3.260401
2004,9750,8594,0,-15,-26,45,71,0,-24.92557
2004,92,8681,0,-3,9,80,71,1,1.903278
2004,1066,8681,0,-7,-5,75,80,0,0.461294
2004,4960,8681,0,1,-2,70,72,0,4.941928
2004,6300,8901,0,-3,-3,75,78,0,1.127671
2004,7152,8901,0,-11,-17,49,66,0,-17.147527
2004,10805,8901,0,-4,8,79,71,1,-6.507386
2004,1365,9003,0,-1,-3,73,76,0,-2.042486
2004,8458,9003,0,7,5,70,65,1,5.40616
2004,4168,9288,0,5,26,100,74,1,3.272155
2004,4283,9288,0,8,-1,75,76,0,7.412656
2004,10385,9288,0,1,-2,100,102,0,-2.785401
2004,7019,9387,0,11,9,53,44,1,16.541502
2004,5948,9455,0,11,9,61,52,1,12.711855
2004,8594,9750,0,15,26,71,45,1,24.92557
2004,783,9784,0,5,7,58,51,1,-0.25158
2004,4960,9866,0,9,3,86,83,1,6.323815
2004,10351,9903,0,9,1,79,78,1,12.936163
2004,3287,9937,0,13,27,76,49,1,19.395637
2004,1798,9971,0,4,20,73,53,1,5.589513
2004,5948,9971,0,3,-2,73,75,0,2.825915
2004,10277,9971,0,-5,-13,58,71,0,-3.315292
2004,1798,10005,0,13,17,70,53,1,24.721518
2004,9971,10277,0,5,13,71,58,1,3.315292
2004,4824,10351,0,-8,-4,80,84,0,-11.378771
2004,8458,10351,0,3,4,84,80,1,0.513394
2004,9903,10351,0,-9,-1,78,79,0,-12.936163
2004,9288,10385,0,-1,2,102,100,1,2.785401
2004,7019,10683,0,3,4,59,55,1,-0.232003
2004,7376,10683,0,-5,-12,64,76,0,-8.601358
2004,2359,10805,0,6,3,66,63,1,13.707724
2004,4615,10805,0,-3,-10,70,80,0,7.326536
2004,5367,10805,0,5,-15,74,89,0,5.226673
2004,8901,10805,0,4,-8,71,79,0,6.507386
2005,10550,93,0,-7,10,83,73,1,-8.386502
2005,6581,112,0,0,10,79,69,1,9.319717
2005,3765,308,0,2,1,90,89,1,6.590141
2005,6718,308,0,1,-1,78,79,0,4.985138
2005,9289,308,0,-8,-22,63,85,0,-6.818966
2005,9819,308,0,-11,-13,53,66,0,-4.200823
2005,6918,784,0,-9,-20,65,85,0,-9.385946
2005,10550,784,0,-8,8,83,75,1,-5.464845
2005,4169,972,0,11,-1,63,64,0,20.328556
2005,10684,972,0,8,9,71,62,1,15.397158
2005,5949,1366,0,-3,12,75,63,1,6.727341
2005,10352,1400,0,13,16,70,54,1,22.80517
2005,3940,1468,0,-3,-12,64,76,0,-1.775876
2005,4284,1468,0,5,9,69,60,1,2.540506
2005,5949,1799,0,-8,3,65,62,1,-3.391349
2005,9388,1799,0,-13,-6,71,77,0,-25.437645
2005,10488,1900,0,3,2,63,61,1,1.064073
2005,2360,2170,0,15,11,57,46,1,31.742209
2005,2170,2360,0,-15,-11,46,57,0,-31.742209
2005,5266,2360,0,-4,10,78,68,1,-3.853873
2005,5368,2360,0,-8,-8,55,63,0,-12.350423
2005,4284,2462,0,13,8,72,64,1,22.799683
2005,3765,2695,0,15,12,67,55,1,28.247828
2005,6615,2799,0,-9,-5,62,67,0,-16.062416
2005,10040,2799,0,-1,11,76,65,1,-2.63004
2005,3254,3034,0,7,12,80,68,1,7.168792
2005,3034,3254,0,-7,-12,68,80,0,-7.168792
2005,4616,3254,0,1,22,76,54,1,4.508177
2005,9004,3288,0,-3,2,71,69,1,2.854456
2005,10650,3288,0,-11,-10,64,74,0,-13.048187
2005,308,3765,0,-2,-1,89,90,0,-6.590141
2005,2695,3765,0,-15,-12,55,67,0,-28.247828
2005,4616,3765,0,-3,-15,57,72,0,-1.372423
2005,6032,3765,0,-8,-12,59,71,0,-15.541866
2005,6301,3765,0,0,5,75,70,1,4.902626
2005,10550,3765,0,-11,-14,63,77,0,-14.841746
2005,1468,3940,0,3,12,76,64,1,1.775876
2005,5300,3974,0,1,-11,53,64,0,1.242936
2005,6301,3974,0,8,27,92,65,1,17.417438
2005,972,4169,0,-11,1,64,63,1,-20.328556
2005,1468,4284,0,-5,-9,60,69,0,-2.540506
2005,2462,4284,0,-13,-8,64,72,0,-22.799683
2005,5266,4284,0,-3,6,94,88,1,0.960769
2005,9785,4284,0,-4,-10,52,62,0,-6.600889
2005,3254,4616,0,-1,-22,54,76,0,-4.508177
2005,3765,4616,0,3,15,72,57,1,1.372423
2005,9456,4616,0,-9,-6,62,68,0,-17.138394
2005,10386,4616,0,3,-14,79,93,0,-1.960878
2005,10488,4616,0,-3,-8,85,93,0,-11.465116
2005,9289,4752,0,-5,14,82,68,1,-1.733647
2005,2360,5266,0,4,-10,68,78,0,3.853873
2005,4284,5266,0,3,-6,88,94,0,-0.960769
2005,6301,5266,0,4,16,87,71,1,8.194514
2005,6752,5266,0,-7,-8,81,89,0,-14.47548
2005,10006,5266,0,-8,-11,61,72,0,-12.961917
2005,3974,5300,0,-1,11,64,53,1,-1.242936
2005,2360,5368,0,8,8,63,55,1,12.350423
2005,8595,5368,0,1,-23,70,93,0,-2.375262
2005,10386,5533,0,15,11,88,77,1,24.527595
2005,1366,5949,0,3,-12,63,75,0,-6.727341
2005,1799,5949,0,8,-3,62,65,0,3.391349
2005,10684,5949,0,4,9,65,56,1,0.161912
2005,3765,6032,0,8,12,71,59,1,15.541866
2005,8902,6032,0,1,-4,57,61,0,7.838833
2005,10040,6100,0,7,8,55,47,1,7.252193
2005,6684,6200,0,11,17,84,67,1,17.767719
2005,3765,6301,0,0,-5,70,75,0,-4.902626
2005,3974,6301,0,-8,-27,65,92,0,-17.417438
2005,5266,6301,0,-4,-16,71,87,0,-8.194514
2005,6581,6301,0,-15,-28,68,96,0,-31.361881
2005,10040,6301,0,-4,-1,66,67,0,-10.373884
2005,10684,6301,0,-5,-6,82,88,0,-12.184214
2005,10684,6460,0,5,5,57,52,1,7.13574
2005,112,6581,0,0,-10,69,79,0,-9.319717
2005,6301,6581,0,15,28,96,68,1,31.361881
2005,2799,6615,0,9,5,67,62,1,16.062416
2005,6200,6684,0,-11,-17,67,84,0,-17.767719
2005,9785,6684,0,-3,9,67,58,1,-7.88764
2005,308,6718,0,-1,1,79,78,1,-4.985138
2005,7560,6718,0,-5,-8,77,85,0,-11.158598
2005,7908,6718,0,-13,-13,50,63,0,-23.517733
2005,5266,6752,0,7,8,89,81,1,14.47548
2005,7020,6884,0,-1,-8,71,79,0,6.630989
2005,10386,6884,0,7,18,97,79,1,12.15081
2005,784,6918,0,9,20,85,65,1,9.385946
2005,6884,7020,0,1,8,79,71,1,-6.630989
2005,6718,7560,0,5,8,85,77,1,11.158598
2005,8527,7560,0,-3,-9,56,65,0,-4.13614
2005,6718,7908,0,13,13,63,50,1,23.517733
2005,7560,8527,0,3,9,65,56,1,4.13614
2005,5368,8595,0,-1,23,93,70,1,2.375262
2005,10006,8682,0,-9,3,60,57,1,-9.398774
2005,6032,8902,0,-1,4,61,57,1,-7.838833
2005,3288,9004,0,3,-2,69,71,0,-2.854456
2005,9422,9004,0,-5,-12,66,78,0,-6.940474
2005,10488,9004,0,-1,5,65,60,1,-5.48043
2005,308,9289,0,8,22,85,63,1,6.818966
2005,4752,9289,0,5,-14,68,82,0,1.733647
2005,1799,9388,0,13,6,77,71,1,25.437645
2005,9004,9422,0,5,12,78,66,1,6.940474
2005,4616,9456,0,9,6,68,62,1,17.138394
2005,4284,9785,0,4,10,62,52,1,6.600889
2005,6684,9785,0,3,-9,58,67,0,7.88764
2005,9867,9785,0,-5,-6,54,60,0,-3.580164
2005,308,9819,0,11,13,66,53,1,4.200823
2005,9785,9867,0,5,6,60,54,1,3.580164
2005,5266,10006,0,8,11,72,61,1,12.961917
2005,8682,10006,0,9,-3,57,60,0,9.398774
2005,2799,10040,0,1,-11,65,76,0,2.63004
2005,6100,10040,0,-7,-8,47,55,0,-7.252193
2005,6301,10040,0,4,1,67,66,1,10.373884
2005,1400,10352,0,-13,-16,54,70,0,-22.80517
2005,10488,10352,0,-5,6,111,105,1,-10.110136
2005,4616,10386,0,-3,14,93,79,1,1.960878
2005,5533,10386,0,-15,-11,77,88,0,-24.527595
2005,6884,10386,0,-7,-18,79,97,0,-12.15081
2005,1900,10488,0,-3,-2,61,63,0,-1.064073
2005,4616,10488,0,3,8,93,85,1,11.465116
2005,9004,10488,0,1,-5,60,65,0,5.48043
2005,10352,10488,0,5,-6,105,111,0,10.110136
2005,93,10550,0,7,-10,73,83,0,8.386502
2005,784,10550,0,8,-8,75,83,0,5.464845
2005,3765,10550,0,11,14,77,63,1,14.841746
2005,3288,10650,0,11,10,74,64,1,13.048187
2005,972,10684,0,-8,-9,62,71,0,-15.397158
2005,5949,10684,0,-4,-9,56,65,0,-0.161912
2005,6301,10684,0,5,6,88,82,1,12.184214
2005,6460,10684,0,-5,-5,52,57,0,-7.13574
2006,3766,26,0,9,9,78,69,1,6.733241
2006,4894,94,0,3,-5,85,90,0,1.640175
2006,9423,94,0,8,3,62,59,1,6.317844
2006,1800,166,0,15,13,72,59,1,22.595429
2006,10041,309,0,7,4,82,78,1,5.548336
2006,10685,309,0,-1,-19,75,94,0,-0.930135
2006,973,431,0,-1,4,59,55,1,-7.836027
2006,9423,662,0,13,34,78,44,1,18.757967
2006,5534,785,0,-8,-13,56,69,0,-8.935595
2006,6885,785,0,-9,-12,76,88,0,-6.110703
2006,10041,785,0,3,1,60,59,1,6.013779
2006,4170,887,0,9,-4,73,77,0,9.057691
2006,5098,887,0,12,16,80,64,1,7.034413
2006,7021,887,0,8,-6,66,72,0,5.155764
2006,431,973,0,1,-4,55,59,0,7.836027
2006,5098,973,0,8,16,72,56,1,11.158336
2006,5950,1160,0,-3,6,58,52,1,1.317583
2006,166,1800,0,-15,-13,59,72,0,-22.595429
2006,3119,1800,0,-10,2,86,84,1,-11.122383
2006,4285,1800,0,-7,-4,83,87,0,-9.480319
2006,10387,1800,0,-4,-6,92,98,0,-4.231503
2006,6650,2069,0,13,8,70,62,1,15.129238
2006,3035,2361,0,-7,-13,61,74,0,-12.393102
2006,4753,2361,0,-3,8,62,54,1,-6.158237
2006,8260,2361,0,-15,-16,54,70,0,-29.355646
2006,3119,2800,0,-8,-15,58,73,0,-7.697559
2006,3153,2800,0,-4,-4,53,57,0,-5.184287
2006,8114,2800,0,-11,-26,50,76,0,-13.437533
2006,9423,2800,0,1,-16,57,73,0,-1.951773
2006,10041,2800,0,2,-13,62,75,0,1.352327
2006,10551,2800,0,-8,-22,60,82,0,-10.542326
2006,2361,3035,0,7,13,74,61,1,12.393102
2006,9616,3035,0,-1,-3,85,88,0,-1.630117
2006,1800,3119,0,10,-2,84,86,0,11.122383
2006,2800,3119,0,8,15,73,58,1,7.697559
2006,5267,3119,0,5,-10,65,75,0,2.038285
2006,6302,3119,0,8,-5,60,65,0,8.898842
2006,10585,3119,0,4,-8,55,63,0,-0.010507
2006,2800,3153,0,4,4,57,53,1,5.184287
2006,6461,3153,0,-3,-5,49,54,0,-1.642982
2006,6650,3153,0,5,-18,52,70,0,4.000451
2006,3839,3289,0,-3,-10,80,90,0,0.620799
2006,9423,3289,0,1,2,73,71,1,4.541474
2006,10807,3289,0,-11,-4,75,79,0,-1.758238
2006,5500,3351,0,0,22,71,49,1,5.758981
2006,26,3766,0,-9,-9,69,78,0,-6.733241
2006,10387,3766,0,-1,3,67,64,1,0.398818
2006,3289,3839,0,3,10,90,80,1,-0.620799
2006,7714,3839,0,-5,-4,83,87,0,-2.476512
2006,4753,3907,0,9,16,80,64,1,9.712657
2006,6529,3941,0,-11,1,64,63,1,-11.619176
2006,887,4170,0,-9,4,77,73,1,-9.057691
2006,7021,4251,0,7,15,79,64,1,10.147951
2006,1800,4285,0,7,4,87,83,1,9.480319
2006,9290,4285,0,-1,-5,64,69,0,-2.938656
2006,2361,4753,0,3,-8,54,62,0,6.158237
2006,3907,4753,0,-9,-16,64,80,0,-9.712657
2006,8903,4753,0,2,-10,60,70,0,5.763057
2006,8937,4753,0,-8,-1,57,58,0,-3.532488
2006,9423,4753,0,2,14,59,45,1,-0.185293
2006,94,4894,0,-3,5,90,85,1,-1.640175
2006,887,5098,0,-12,-16,64,80,0,-7.034413
2006,973,5098,0,-8,-16,56,72,0,-11.158336
2006,6783,5098,0,-15,-16,78,94,0,-15.253034
2006,9423,5098,0,-1,5,50,45,1,-1.852033
2006,3119,5267,0,-5,10,75,65,1,-2.038285
2006,3351,5500,0,0,-22,49,71,0,-5.758981
2006,10041,5500,0,15,13,58,45,1,23.878131
2006,785,5534,0,8,13,69,56,1,8.935595
2006,6033,5534,0,7,-8,79,87,0,6.207345
2006,6302,5770,0,11,4,69,65,1,15.774322
2006,1160,5950,0,3,-6,52,58,0,-1.317583
2006,8903,5950,0,8,21,75,54,1,9.10252
2006,5534,6033,0,-7,8,87,79,1,-6.207345
2006,3119,6302,0,-8,5,65,60,1,-8.898842
2006,5770,6302,0,-11,-4,65,69,0,-15.774322
2006,3153,6461,0,3,5,54,49,1,1.642982
2006,3941,6529,0,11,-1,63,64,0,11.619176
2006,10489,6529,0,8,13,67,54,1,10.647405
2006,2069,6650,0,-13,-8,62,70,0,-15.129238
2006,3153,6650,0,-5,18,70,52,1,-4.000451
2006,10551,6685,0,-5,8,82,74,1,-4.607673
2006,5098,6783,0,15,16,94,78,1,15.253034
2006,785,6885,0,9,12,88,76,1,6.110703
2006,8903,6919,0,13,8,60,52,1,16.555061
2006,887,7021,0,-8,6,72,66,1,-5.155764
2006,4251,7021,0,-7,-15,64,79,0,-10.147951
2006,10489,7561,0,5,18,64,46,1,4.547849
2006,3839,7714,0,5,4,87,83,1,2.476512
2006,10585,7980,0,3,20,86,66,1,3.337497
2006,2800,8114,0,11,26,76,50,1,13.437533
2006,2361,8260,0,15,16,70,54,1,29.355646
2006,8937,8683,0,-7,8,66,58,1,1.287123
2006,10585,8801,0,-5,7,80,73,1,-4.223464
2006,10651,8801,0,-13,-2,61,63,0,-8.780122
2006,4753,8903,0,-2,10,70,60,1,-5.763057
2006,5950,8903,0,-8,-21,54,75,0,-9.10252
2006,6919,8903,0,-13,-8,52,60,0,-16.555061
2006,10489,8903,0,-4,-3,71,74,0,-8.659562
2006,4753,8937,0,8,1,58,57,1,3.532488
2006,8683,8937,0,7,-8,58,66,0,-1.287123
2006,4285,9290,0,1,5,69,64,1,2.938656
2006,94,9423,0,-8,-3,59,62,0,-6.317844
2006,662,9423,0,-13,-34,44,78,0,-18.757967
2006,2800,9423,0,-1,16,73,57,1,1.951773
2006,3289,9423,0,-1,-2,71,73,0,-4.541474
2006,4753,9423,0,-2,-14,45,59,0,0.185293
2006,5098,9423,0,1,-5,45,50,0,1.852033
2006,3035,9616,0,1,3,88,85,1,1.630117
2006,10387,9820,0,7,14,75,61,1,9.477674
2006,309,10041,0,-7,-4,78,82,0,-5.548336
2006,785,10041,0,-3,-1,59,60,0,-6.013779
2006,2800,10041,0,-2,13,75,62,1,-1.352327
2006,5500,10041,0,-15,-13,45,58,0,-23.878131
2006,1800,10387,0,4,6,98,92,1,4.231503
2006,3766,10387,0,1,-3,64,67,0,-0.398818
2006,9820,10387,0,-7,-14,61,75,0,-9.477674
2006,6529,10489,0,-8,-13,54,67,0,-10.647405
2006,7561,10489,0,-5,-18,46,64,0,-4.547849
2006,8903,10489,0,4,3,74,71,1,8.659562
2006,2800,10551,0,8,22,82,60,1,10.542326
2006,6685,10551,0,5,-8,74,82,0,4.607673
2006,3119,10585,0,-4,8,63,55,1,0.010507
2006,7980,10585,0,-3,-20,66,86,0,-3.337497
2006,8801,10585,0,5,-7,73,80,0,4.223464
2006,8801,10651,0,13,2,63,61,1,8.780122
2006,309,10685,0,1,19,94,75,1,0.930135
2006,3289,10807,0,11,4,79,75,1,1.758238
2007,10076,167,0,9,27,84,57,1,14.394185
2007,7223,310,0,-1,9,72,63,1,-1.901347
2007,9685,432,0,7,17,77,60,1,-1.544773
2007,3154,663,0,13,25,80,55,1,18.0665
2007,3154,786,0,5,7,62,55,1,5.451616
2007,9006,786,0,-3,-9,75,84,0,-3.919498
2007,2801,1035,0,4,8,65,57,1,9.724866
2007,4963,1035,0,1,-3,59,62,0,5.831319
2007,6754,1035,0,-7,-11,46,57,0,-5.659382
2007,10808,1069,0,-1,2,79,77,1,3.140199
2007,6651,1300,0,15,21,78,57,1,25.270179
2007,6034,1902,0,3,6,77,71,1,-2.26203
2007,4963,2070,0,9,12,82,70,1,10.519093
2007,9906,2362,0,-5,2,79,77,1,-10.790119
2007,6303,2464,0,15,21,86,65,1,31.882109
2007,1035,2801,0,-4,-8,57,65,0,-9.724866
2007,4046,2801,0,-15,-43,69,112,0,-35.34442
2007,6651,2801,0,0,-9,75,84,0,-1.65215
2007,6818,2801,0,-2,-8,77,85,0,-7.45348
2007,7223,2801,0,-8,-7,67,74,0,-8.806047
2007,9424,2801,0,-1,-10,66,76,0,-3.064768
2007,6202,2835,0,0,8,77,69,1,6.790189
2007,9974,3036,0,5,33,77,44,1,5.105506
2007,663,3154,0,-13,-25,55,80,0,-18.0665
2007,786,3154,0,-5,-7,55,62,0,-5.451616
2007,6303,3154,0,1,-12,84,96,0,7.985888
2007,6651,3154,0,1,7,67,60,1,2.255183
2007,9974,3154,0,-4,-1,65,66,0,-7.938615
2007,9651,3256,0,3,4,67,63,1,-5.812315
2007,3840,3290,0,3,13,70,57,1,4.184677
2007,7562,3547,0,9,10,61,51,1,9.727193
2007,10110,3767,0,7,2,54,52,1,0.592409
2007,3290,3840,0,-3,-13,57,70,0,-4.184677
2007,9424,3840,0,5,5,54,49,1,3.473697
2007,2801,4046,0,15,43,112,69,1,35.34442
2007,4286,4171,0,-7,-12,76,88,0,-6.260962
2007,6202,4171,0,-15,-40,67,107,0,-26.283218
2007,7562,4171,0,-3,-3,58,61,0,-10.107493
2007,9424,4171,0,-1,13,68,55,1,-2.933037
2007,4171,4286,0,7,12,88,76,1,6.260962
2007,10042,4286,0,-1,-9,58,67,0,-0.393819
2007,8802,4502,0,7,35,121,86,1,11.148063
2007,8597,4618,0,-5,-20,58,78,0,-4.773981
2007,8938,4618,0,3,3,72,69,1,6.17577
2007,5268,4895,0,-1,12,61,49,1,2.200394
2007,1035,4963,0,-1,3,62,59,1,-5.831319
2007,2070,4963,0,-9,-12,70,82,0,-10.519093
2007,6034,5099,0,-5,-16,62,78,0,-9.476634
2007,6360,5099,0,-13,-15,58,73,0,-23.404879
2007,6651,5099,0,1,16,92,76,1,1.566127
2007,8938,5099,0,-1,-1,64,65,0,1.747592
2007,6818,5200,0,11,2,58,56,1,11.103837
2007,4895,5268,0,1,-12,49,61,0,-2.200394
2007,6303,5268,0,8,14,81,67,1,10.991718
2007,1902,6034,0,-3,-6,71,77,0,2.26203
2007,5099,6034,0,5,16,78,62,1,9.476634
2007,8904,6136,0,9,12,79,67,1,11.395132
2007,2835,6202,0,0,-8,69,77,0,-6.790189
2007,4171,6202,0,15,40,107,67,1,26.283218
2007,2464,6303,0,-15,-21,65,86,0,-31.882109
2007,3154,6303,0,-1,12,96,84,1,-7.985888
2007,5268,6303,0,-8,-14,67,81,0,-10.991718
2007,9685,6303,0,-4,-10,64,74,0,-14.853212
2007,5099,6360,0,13,15,73,58,1,23.404879
2007,10652,6564,0,-5,10,74,64,1,-9.131002
2007,1300,6651,0,-15,-21,57,78,0,-25.270179
2007,2801,6651,0,0,9,84,75,1,1.65215
2007,3154,6651,0,-1,-7,60,67,0,-2.255183
2007,5099,6651,0,-1,-16,76,92,0,-1.566127
2007,8802,6651,0,-4,-1,84,85,0,-7.631424
2007,10808,6651,0,-8,-7,71,78,0,-7.285672
2007,1035,6754,0,7,11,57,46,1,5.659382
2007,10422,6784,0,11,16,70,54,1,8.005112
2007,2801,6818,0,2,8,85,77,1,7.45348
2007,5200,6818,0,-11,-2,56,58,0,-11.103837
2007,9651,6818,0,-4,-4,72,76,0,-3.644868
2007,10652,6818,0,-8,-14,61,75,0,-7.178559
2007,8938,6920,0,11,16,68,52,1,17.638784
2007,9424,7022,0,1,9,64,55,1,3.141599
2007,9906,7022,0,-8,-5,79,84,0,-8.356259
2007,10740,7022,0,-11,-21,58,79,0,-14.93827
2007,310,7223,0,1,-9,63,72,0,1.901347
2007,2801,7223,0,8,7,74,67,1,8.806047
2007,3547,7562,0,-9,-10,51,61,0,-9.727193
2007,4171,7562,0,3,3,61,58,1,10.107493
2007,10110,7562,0,-1,-15,48,63,0,2.086625
2007,4618,8597,0,5,20,78,58,1,4.773981
2007,10686,8700,0,13,13,76,63,1,16.96313
2007,4502,8802,0,-7,-35,86,121,0,-11.148063
2007,6651,8802,0,4,1,85,84,1,7.631424
2007,10076,8802,0,1,-3,74,77,0,-0.919559
2007,6136,8904,0,-9,-12,67,79,0,-11.395132
2007,9685,8904,0,-1,19,87,68,1,-4.02063
2007,4618,8938,0,-3,-3,69,72,0,-6.17577
2007,5099,8938,0,1,1,65,64,1,-1.747592
2007,6920,8938,0,-11,-16,52,68,0,-17.638784
2007,786,9006,0,3,9,84,75,1,3.919498
2007,2801,9424,0,1,10,76,66,1,3.064768
2007,3840,9424,0,-5,-5,49,54,0,-3.473697
2007,4171,9424,0,1,-13,55,68,0,2.933037
2007,7022,9424,0,-1,-9,55,64,0,-3.141599
2007,10456,9424,0,-13,-28,42,70,0,-23.780422
2007,3256,9651,0,-3,-4,63,67,0,5.812315
2007,6818,9651,0,4,4,76,72,1,3.644868
2007,10686,9651,0,5,-6,68,74,0,7.666097
2007,432,9685,0,-7,-17,60,77,0,1.544773
2007,6303,9685,0,4,10,74,64,1,14.853212
2007,8904,9685,0,1,-19,68,87,0,4.02063
2007,2362,9906,0,5,-2,77,79,0,10.790119
2007,7022,9906,0,8,5,84,79,1,8.356259
2007,3036,9974,0,-5,-33,44,77,0,-5.105506
2007,3154,9974,0,4,1,66,65,1,7.938615
2007,10422,9974,0,3,-4,74,78,0,1.621073
2007,4286,10042,0,1,9,67,58,1,0.393819
2007,167,10076,0,-9,-27,57,84,0,-14.394185
2007,8802,10076,0,-1,3,77,74,1,0.919559
2007,3767,10110,0,-7,-2,52,54,0,-0.592409
2007,7562,10110,0,1,15,63,48,1,-2.086625
2007,6784,10422,0,-11,-16,54,70,0,-8.005112
2007,9974,10422,0,-3,4,78,74,1,-1.621073
2007,9424,10456,0,13,28,70,42,1,23.780422
2007,6564,10652,0,5,-10,64,74,0,9.131002
2007,6818,10652,0,8,14,75,61,1,7.178559
2007,8700,10686,0,-13,-13,63,76,0,-16.96313
2007,9651,10686,0,-5,6,74,68,1,-7.666097
2007,7022,10740,0,11,21,79,58,1,14.93827
2007,1069,10808,0,1,-2,77,79,0,-3.140199
2007,6651,10808,0,8,7,78,71,1,7.285672
2008,8803,243,0,13,15,72,57,1,21.380693
2008,10491,311,0,3,10,75,65,1,2.338831
2008,3841,433,0,1,-14,72,86,0,3.84815
2008,6304,433,0,8,31,108,77,1,10.403706
2008,8905,577,0,13,20,74,54,1,21.253928
2008,7224,645,0,5,11,90,79,1,0.84264
2008,2363,664,0,13,1,71,70,1,23.881157
2008,4619,753,0,11,18,79,61,1,15.937913
2008,8116,1036,0,-3,-20,61,81,0,-5.112795
2008,8803,1036,0,5,5,76,71,1,7.064182
2008,8939,1070,0,-1,5,67,62,1,4.412881
2008,10043,1539,0,-7,6,75,69,1,-7.337223
2008,7682,1802,0,-9,1,70,69,1,-13.380202
2008,5704,1835,0,0,9,69,60,1,11.266701
2008,8598,1869,0,11,24,77,53,1,16.094339
2008,10687,1948,0,11,15,71,56,1,14.827359
2008,3155,2071,0,8,-4,70,74,0,6.446837
2008,3291,2071,0,3,-6,76,82,0,2.550095
2008,4172,2071,0,9,2,59,57,1,14.481846
2008,10687,2071,0,7,-17,56,73,0,7.645998
2008,10247,2295,0,-7,2,101,99,1,-5.440014
2008,664,2363,0,-13,-1,70,71,0,-23.881157
2008,10491,2363,0,-5,6,73,67,1,-5.043162
2008,6565,3121,0,7,18,68,50,1,9.626285
2008,2071,3155,0,-8,4,74,70,1,-6.446837
2008,9525,3155,0,-13,-19,47,66,0,-18.845043
2008,10809,3189,0,11,12,73,61,1,10.546263
2008,2071,3291,0,-3,6,82,76,1,-2.550095
2008,433,3841,0,-1,14,86,72,1,-3.84815
2008,2071,4172,0,-9,-2,57,59,0,-14.481846
2008,5100,4172,0,0,-7,68,75,0,-4.049185
2008,6304,4172,0,0,-18,66,84,0,-3.939572
2008,7077,4172,0,-15,-24,61,85,0,-24.891571
2008,9652,4172,0,-7,-19,56,75,0,-16.676763
2008,10043,4172,0,-11,-15,57,72,0,-16.60956
2008,9686,4206,0,5,-13,67,80,0,-1.916927
2008,10687,4206,0,8,17,72,55,1,3.483111
2008,9652,4253,0,1,13,71,58,1,2.243371
2008,4896,4287,0,5,8,74,66,1,9.133221
2008,753,4619,0,-11,-18,61,79,0,-15.937913
2008,6304,4619,0,2,10,83,73,1,5.171775
2008,6687,4619,0,-3,-30,48,78,0,-5.13707
2008,8803,4619,0,1,-19,60,79,0,1.324085
2008,4287,4896,0,-5,-8,66,74,0,-9.133221
2008,8598,4896,0,3,1,82,81,1,-1.304394
2008,4172,5100,0,0,7,75,68,1,4.049185
2008,5269,5100,0,-4,-18,74,92,0,-6.438928
2008,5371,5100,0,-7,-3,74,77,0,-9.987788
2008,8905,5100,0,-1,-18,67,85,0,-4.383509
2008,9425,5100,0,0,-15,63,78,0,-0.546411
2008,9720,5100,0,-15,-24,63,87,0,-25.828669
2008,8530,5167,0,-3,-14,64,78,0,0.671582
2008,8905,5167,0,5,3,75,72,1,7.199474
2008,5100,5269,0,4,18,92,74,1,6.438928
2008,7023,5269,0,1,-11,54,65,0,-0.65529
2008,8769,5269,0,-7,-11,61,72,0,-8.11638
2008,5100,5371,0,7,3,77,74,1,9.987788
2008,6819,5371,0,-1,-7,69,76,0,-0.423243
2008,9425,5674,0,15,41,70,29,1,37.483389
2008,1835,5704,0,0,-9,60,69,0,-11.266701
2008,6304,5704,0,15,39,113,74,1,26.136398
2008,433,6304,0,-8,-31,77,108,0,-10.403706
2008,4172,6304,0,0,18,84,66,1,3.939572
2008,4619,6304,0,-2,-10,73,83,0,-5.171775
2008,5704,6304,0,-15,-39,74,113,0,-26.136398
2008,10423,6304,0,-3,-21,47,68,0,-6.753207
2008,3121,6565,0,-7,-18,50,68,0,-9.626285
2008,10423,6565,0,1,20,61,41,1,0.274448
2008,4619,6687,0,3,30,78,48,1,5.13707
2008,8462,6687,0,-5,-8,64,72,0,-2.879305
2008,7023,6785,0,9,19,82,63,1,9.014935
2008,5371,6819,0,1,7,76,69,1,0.423243
2008,5269,7023,0,-1,11,65,54,1,0.65529
2008,6785,7023,0,-9,-19,63,82,0,-9.014935
2008,4172,7077,0,15,24,85,61,1,24.891571
2008,645,7224,0,-5,-11,79,90,0,-0.84264
2008,10809,7224,0,3,7,85,78,1,4.544805
2008,1802,7682,0,9,-1,69,70,0,13.380202
2008,10247,7682,0,1,9,72,63,1,6.389581
2008,9975,8048,0,9,-21,62,83,0,8.260616
2008,10043,8048,0,1,12,84,72,1,6.966545
2008,1036,8116,0,3,20,81,61,1,5.112795
2008,6687,8462,0,5,8,72,64,1,2.879305
2008,5167,8530,0,3,14,78,64,1,-0.671582
2008,1869,8598,0,-11,-24,53,77,0,-16.094339
2008,4896,8598,0,-3,-1,81,82,0,1.304394
2008,8905,8598,0,1,20,82,62,1,1.45072
2008,5269,8769,0,7,11,72,61,1,8.11638
2008,243,8803,0,-13,-15,57,72,0,-21.380693
2008,1036,8803,0,-5,-5,71,76,0,-7.064182
2008,4619,8803,0,-1,19,79,60,1,-1.324085
2008,577,8905,0,-13,-20,54,74,0,-21.253928
2008,5100,8905,0,1,18,85,67,1,4.383509
2008,5167,8905,0,-5,-3,72,75,0,-7.199474
2008,8598,8905,0,-1,-20,62,82,0,-1.45072
2008,1070,8939,0,1,-5,62,67,0,-4.412881
2008,9425,8939,0,8,2,51,49,1,5.851576
2008,5100,9425,0,0,15,78,63,1,0.546411
2008,5674,9425,0,-15,-41,29,70,0,-37.483389
2008,8939,9425,0,-8,-2,49,51,0,-5.851576
2008,10247,9425,0,-11,-10,78,88,0,-13.429986
2008,10809,9425,0,-2,-19,57,76,0,-4.848166
2008,3155,9525,0,13,19,66,47,1,18.845043
2008,4172,9652,0,7,19,75,56,1,16.676763
2008,4253,9652,0,-1,-13,58,71,0,-2.243371
2008,4206,9686,0,-5,13,80,67,1,1.916927
2008,5100,9720,0,15,24,87,63,1,25.828669
2008,8048,9975,0,-9,21,83,62,1,-8.260616
2008,1539,10043,0,7,-6,69,75,0,7.337223
2008,4172,10043,0,11,15,72,57,1,16.60956
2008,8048,10043,0,-1,-12,72,84,0,-6.966545
2008,2295,10247,0,7,-2,99,101,0,5.440014
2008,7682,10247,0,-1,-9,63,72,0,-6.389581
2008,9425,10247,0,11,10,88,78,1,13.429986
2008,6304,10423,0,3,21,68,47,1,6.753207
2008,6565,10423,0,-1,-20,41,61,0,-0.274448
2008,10653,10423,0,-9,-31,40,71,0,-12.19457
2008,311,10491,0,-3,-10,65,75,0,-2.338831
2008,2363,10491,0,5,-6,67,73,0,5.043162
2008,10809,10491,0,4,4,79,75,1,-0.167523
2008,10423,10653,0,9,31,71,40,1,12.19457
2008,1948,10687,0,-11,-15,56,71,0,-14.827359
2008,2071,10687,0,-7,17,73,56,1,-7.645998
2008,4206,10687,0,-8,-17,55,72,0,-3.483111
2008,3189,10809,0,-11,-12,61,73,0,-10.546263
2008,7224,10809,0,-3,-7,78,85,0,-4.544805
2008,9425,10809,0,2,19,76,57,1,4.848166
2008,10491,10809,0,-4,-4,75,79,0,0.167523
2009,3292,63,0,9,13,77,64,1,16.604644
2009,5605,150,0,0,15,58,43,1,1.807134
2009,10044,244,0,11,13,80,67,1,16.761551
2009,1574,312,0,-1,-14,57,71,0,-5.944102
2009,4620,312,0,11,39,103,64,1,8.202834
2009,9789,312,0,7,-13,71,84,0,0.869086
2009,8686,346,0,3,11,78,67,1,-0.007685
2009,8770,346,0,-5,-9,57,66,0,-8.53209
2009,2364,716,0,13,24,86,62,1,24.391366
2009,9687,788,0,-3,17,72,55,1,3.726505
2009,4756,1037,0,1,4,75,71,1,1.894876
2009,8940,1071,0,-1,13,79,66,1,-5.959759
2009,4965,1163,0,-3,13,84,71,1,-3.154577
2009,1803,1404,0,15,56,103,47,1,26.453395
2009,5236,1540,0,-3,3,62,59,1,-4.993852
2009,312,1574,0,1,14,71,57,1,5.944102
2009,10356,1574,0,9,-15,69,84,0,10.004569
2009,1404,1803,0,-15,-56,47,103,0,-26.453395
2009,5270,1803,0,-1,9,82,73,1,-3.933126
2009,5406,1803,0,-2,-7,75,82,0,-1.182935
2009,7225,1803,0,-4,-12,60,72,0,-4.2376
2009,8940,1803,0,-8,-26,66,92,0,-10.706738
2009,5406,1870,0,11,19,78,59,1,16.786217
2009,5101,1977,0,13,11,81,70,1,19.231002
2009,4173,2106,0,8,17,60,43,1,11.791363
2009,10492,2106,0,5,-8,60,68,0,12.63028
2009,716,2364,0,-13,-24,62,86,0,-24.391366
2009,8906,2364,0,-5,-5,69,74,0,-6.483447
2009,10044,2364,0,-1,23,77,54,1,-4.653559
2009,7024,2631,0,15,10,72,62,1,20.628904
2009,10688,2902,0,-7,2,61,59,1,1.077406
2009,63,3292,0,-9,-13,64,77,0,-16.604644
2009,6305,3292,0,3,21,98,77,1,4.394926
2009,10248,3292,0,-8,-2,81,83,0,-16.995458
2009,10248,3769,0,-7,4,76,72,1,-11.997518
2009,2106,4173,0,-8,-17,43,60,0,-11.791363
2009,5270,4173,0,1,5,67,62,1,-1.481702
2009,5800,4173,0,-11,-10,74,84,0,-11.825043
2009,312,4620,0,-11,-39,64,103,0,-8.202834
2009,5270,4620,0,-1,12,64,52,1,-3.873095
2009,5605,4620,0,-15,-20,54,74,0,-24.568854
2009,8049,4620,0,-8,-7,72,79,0,-13.145062
2009,1037,4756,0,-1,-4,71,75,0,-1.894876
2009,6305,4756,0,7,14,84,70,1,12.205828
2009,5406,4897,0,3,4,83,79,1,4.050608
2009,9823,4897,0,-5,-1,57,58,0,-5.905217
2009,1163,4965,0,3,-13,71,84,0,3.154577
2009,5101,4965,0,8,19,89,70,1,10.640131
2009,1977,5101,0,-13,-11,70,81,0,-19.231002
2009,4965,5101,0,-8,-19,70,89,0,-10.640131
2009,5406,5101,0,-1,11,102,91,1,-1.878674
2009,1540,5236,0,3,-3,59,62,0,4.993852
2009,6688,5236,0,8,10,73,63,1,6.436714
2009,1803,5270,0,1,-9,73,82,0,3.933126
2009,4173,5270,0,-1,-5,62,67,0,1.481702
2009,4620,5270,0,1,-12,52,64,0,3.873095
2009,6305,5270,0,1,17,89,72,1,7.297306
2009,7449,5270,0,-13,-15,62,77,0,-17.581282
2009,9687,5270,0,-8,-5,69,74,0,-2.728481
2009,8906,5304,0,3,14,76,62,1,2.846067
2009,10390,5372,0,9,13,71,58,1,7.832184
2009,1803,5406,0,2,7,82,75,1,1.182935
2009,1870,5406,0,-11,-19,59,78,0,-16.786217
2009,4897,5406,0,-3,-4,79,83,0,-4.050608
2009,5101,5406,0,1,-11,91,102,0,1.878674
2009,150,5605,0,0,-15,43,58,0,-1.807134
2009,4620,5605,0,15,20,74,54,1,24.568854
2009,6688,5639,0,13,28,82,54,1,19.898912
2009,4173,5800,0,11,10,84,74,1,11.825043
2009,3292,6305,0,-3,-21,77,98,0,-4.394926
2009,4756,6305,0,-7,-14,70,84,0,-12.205828
2009,5270,6305,0,-1,-17,72,89,0,-7.297306
2009,6688,6305,0,-1,-12,60,72,0,-6.686529
2009,7279,6305,0,-15,-43,58,101,0,-27.432746
2009,10044,6305,0,-2,-14,69,83,0,-7.924358
2009,7225,6464,0,7,5,61,56,1,11.113174
2009,8049,6653,0,-1,2,74,72,1,-4.870638
2009,5236,6688,0,-8,-10,63,73,0,-6.436714
2009,5639,6688,0,-13,-28,54,82,0,-19.898912
2009,6305,6688,0,1,12,72,60,1,6.686529
2009,8686,6688,0,-1,-13,71,84,0,-0.18687
2009,7024,6722,0,7,8,84,76,1,7.910601
2009,8804,6722,0,-1,-2,75,77,0,0.143583
2009,2631,7024,0,-15,-10,62,72,0,-20.628904
2009,6722,7024,0,-7,-8,76,84,0,-7.910601
2009,10044,7024,0,-2,2,78,76,1,-5.428447
2009,10810,7024,0,-3,-5,55,60,0,-7.821963
2009,10810,7078,0,9,18,77,59,1,11.793675
2009,1803,7225,0,4,12,72,60,1,4.2376
2009,6464,7225,0,-7,-5,56,61,0,-11.113174
2009,10390,7225,0,1,-2,74,76,0,0.666819
2009,6305,7279,0,15,43,101,58,1,27.432746
2009,5270,7449,0,13,15,77,62,1,17.581282
2009,8686,8015,0,11,15,59,44,1,15.82521
2009,4620,8049,0,8,7,79,72,1,13.145062
2009,6653,8049,0,1,-2,72,74,0,4.870638
2009,346,8686,0,-3,-11,67,78,0,0.007685
2009,6688,8686,0,1,13,84,71,1,0.18687
2009,8015,8686,0,-11,-15,44,59,0,-15.82521
2009,346,8770,0,5,9,66,57,1,8.53209
2009,6722,8804,0,1,2,77,75,1,-0.143583
2009,2364,8906,0,5,5,74,69,1,6.483447
2009,5304,8906,0,-3,-14,62,76,0,-2.846067
2009,1071,8940,0,1,-13,66,79,0,5.959759
2009,1803,8940,0,8,26,92,66,1,10.706738
2009,9908,9426,0,-5,-1,64,65,0,-12.831801
2009,10044,9426,0,3,20,89,69,1,-3.614828
2009,788,9687,0,3,-17,55,72,0,-3.726505
2009,5270,9687,0,8,5,74,69,1,2.728481
2009,312,9789,0,-7,13,84,71,1,-0.869086
2009,4897,9823,0,5,1,58,57,1,5.905217
2009,9426,9908,0,5,1,65,64,1,12.831801
2009,244,10044,0,-11,-13,67,80,0,-16.761551
2009,2364,10044,0,1,-23,54,77,0,4.653559
2009,6305,10044,0,2,14,83,69,1,7.924358
2009,7024,10044,0,2,-2,76,78,0,5.428447
2009,9426,10044,0,-3,-20,69,89,0,3.614828
2009,3292,10248,0,8,2,83,81,1,16.995458
2009,3769,10248,0,7,-4,72,76,0,11.997518
2009,1574,10356,0,-9,15,84,69,1,-10.004569
2009,5372,10390,0,-9,-13,58,71,0,-7.832184
2009,7225,10390,0,-1,2,76,74,1,-0.666819
2009,2106,10492,0,-5,8,68,60,1,-12.63028
2009,2902,10688,0,7,-2,59,61,0,-1.077406
2009,10810,10688,0,8,11,60,49,1,1.27322
2009,7024,10810,0,3,5,60,55,1,7.821963
2009,7078,10810,0,-9,-18,59,77,0,-11.793675
2009,10688,10810,0,-8,-11,49,60,0,-1.27322
2010,2365,401,0,15,29,73,44,1,34.097974
2010,10655,401,0,0,-17,44,61,0,1.477785
2010,2365,647,0,2,7,78,71,1,7.678108
2010,6757,647,0,-8,-8,68,76,0,-6.18349
2010,7616,647,0,-11,-9,59,68,0,-14.570735
2010,8532,647,0,-7,-23,49,72,0,-3.887249
2010,2365,1038,0,4,2,61,59,1,12.676873
2010,4208,1038,0,3,-7,56,63,0,7.312598
2010,5271,1038,0,0,-2,50,52,0,3.608176
2010,5774,1038,0,-8,-2,52,54,0,-4.272461
2010,8687,1038,0,4,-4,59,63,0,9.307708
2010,9872,1038,0,-7,-18,59,77,0,0.781089
2010,2804,1072,0,-3,-7,92,99,0,-7.06329
2010,4208,1072,0,5,12,84,72,1,0.538853
2010,2365,1164,0,7,15,68,53,1,7.895344
2010,4621,1164,0,-1,-15,62,77,0,-2.751909
2010,5407,1541,0,-3,8,86,78,1,1.248304
2010,4289,1871,0,11,17,62,45,1,14.038842
2010,8771,1871,0,7,-13,65,78,0,6.329382
2010,10689,1871,0,8,-18,69,87,0,12.926953
2010,401,2365,0,-15,-29,44,73,0,-34.097974
2010,647,2365,0,-2,-7,71,78,0,-7.678108
2010,1038,2365,0,-4,-2,59,61,0,-12.676873
2010,1164,2365,0,-7,-15,53,68,0,-7.895344
2010,7226,2365,0,-3,-13,57,70,0,-7.503679
2010,10493,2365,0,-1,-21,57,78,0,-6.354738
2010,4289,2632,0,15,29,100,71,1,21.685548
2010,1072,2804,0,3,7,99,92,1,7.06329
2010,3293,2903,0,1,7,67,60,1,-2.694726
2010,6620,3157,0,-11,14,97,83,1,-14.262359
2010,6654,3259,0,8,9,75,66,1,5.256534
2010,6723,3259,0,3,-5,59,64,0,-1.779828
2010,2903,3293,0,-1,-7,60,67,0,2.694726
2010,8687,3293,0,7,22,87,65,1,9.371849
2010,4966,3584,0,9,12,89,77,1,11.396276
2010,4425,4174,0,-15,-16,74,90,0,-30.064118
2010,6465,4174,0,-8,2,69,67,1,-14.944115
2010,1038,4208,0,-3,7,63,56,1,-7.312598
2010,1072,4208,0,-5,-12,72,84,0,-0.538853
2010,6363,4208,0,-13,-20,62,82,0,-22.139386
2010,10811,4208,0,-4,-5,96,101,0,-4.24806
2010,1871,4289,0,-11,-17,45,62,0,-14.038842
2010,2632,4289,0,-15,-29,71,100,0,-21.685548
2010,10357,4289,0,-8,-30,60,90,0,-8.523442
2010,10493,4289,0,-1,7,73,66,1,-1.641674
2010,4174,4425,0,15,16,90,74,1,30.064118
2010,1164,4621,0,1,15,77,62,1,2.751909
2010,10391,4898,0,-5,2,80,78,1,0.643874
2010,3584,4966,0,-9,-12,77,89,0,-11.396276
2010,5271,4966,0,-1,2,85,83,1,-2.309824
2010,1038,5271,0,0,2,52,50,1,-3.608176
2010,4966,5271,0,1,-2,83,85,0,2.309824
2010,6139,5271,0,-7,-3,67,70,0,-14.264158
2010,6465,5271,0,-4,-7,52,59,0,-5.22341
2010,8805,5271,0,-1,-1,69,70,0,-0.228098
2010,10811,5305,0,5,11,65,54,1,-0.580614
2010,1541,5407,0,3,-8,78,86,0,-1.248304
2010,10493,5407,0,8,9,68,59,1,1.252244
2010,6105,5538,0,11,5,62,57,1,9.407587
2010,10493,5640,0,13,27,77,50,1,20.398535
2010,1038,5774,0,8,2,54,52,1,4.272461
2010,9977,5774,0,9,-1,65,66,0,7.255885
2010,5538,6105,0,-11,-5,57,62,0,-9.407587
2010,10391,6105,0,-8,18,82,64,1,3.167848
2010,5271,6139,0,7,3,70,67,1,14.264158
2010,4208,6363,0,13,20,82,62,1,22.139386
2010,4174,6465,0,8,-2,67,69,0,14.944115
2010,5271,6465,0,4,7,59,52,1,5.22341
2010,9654,6465,0,1,-3,66,69,0,2.122692
2010,6757,6567,0,-5,1,51,50,1,-2.028397
2010,7025,6586,0,11,23,89,66,1,13.714716
2010,3157,6620,0,11,-14,83,97,0,14.262359
2010,8805,6620,0,8,15,83,68,1,12.224505
2010,3259,6654,0,-8,-9,66,75,0,-5.256534
2010,7819,6654,0,-13,-17,51,68,0,-20.133254
2010,8805,6654,0,-4,3,76,73,1,-3.725515
2010,3259,6723,0,-3,5,64,59,1,1.779828
2010,647,6757,0,8,8,76,68,1,6.18349
2010,6567,6757,0,5,-1,50,51,0,2.028397
2010,6586,7025,0,-11,-23,66,89,0,-13.714716
2010,10811,7025,0,-3,3,71,68,1,1.460085
2010,2365,7226,0,3,13,70,57,1,7.503679
2010,8050,7226,0,-9,-8,64,72,0,-9.531607
2010,8941,7226,0,-1,-2,61,63,0,-2.475981
2010,8532,7382,0,-3,9,80,71,1,3.607168
2010,10045,7450,0,13,3,73,70,1,22.570313
2010,647,7616,0,11,9,68,59,1,14.570735
2010,8805,7718,0,5,3,62,59,1,4.485503
2010,6654,7819,0,13,17,68,51,1,20.133254
2010,7226,8050,0,9,8,72,64,1,9.531607
2010,647,8532,0,7,23,72,49,1,3.887249
2010,7382,8532,0,3,-9,71,80,0,-3.607168
2010,10045,8532,0,8,-7,68,75,0,4.040685
2010,1038,8687,0,-4,4,63,59,1,-9.307708
2010,3293,8687,0,-7,-22,65,87,0,-9.371849
2010,10011,8687,0,-15,-23,56,79,0,-23.614467
2010,1871,8771,0,-7,13,78,65,1,-6.329382
2010,5271,8805,0,1,1,70,69,1,0.228098
2010,6620,8805,0,-8,-15,68,83,0,-12.224505
2010,6654,8805,0,4,-3,73,76,0,3.725515
2010,7718,8805,0,-5,-3,59,62,0,-4.485503
2010,10357,8907,0,-1,1,81,80,1,-6.925222
2010,7226,8941,0,1,2,63,61,1,2.475981
2010,9824,8941,0,-7,-16,53,69,0,-1.374947
2010,6465,9654,0,-1,3,69,66,1,-2.122692
2010,8941,9824,0,7,16,69,53,1,1.374947
2010,1038,9872,0,7,18,77,59,1,-0.781089
2010,5774,9977,0,-9,1,66,65,1,-7.255885
2010,8687,10011,0,15,23,79,56,1,23.614467
2010,7450,10045,0,-13,-3,70,73,0,-22.570313
2010,8532,10045,0,-8,7,75,68,1,-4.040685
2010,4289,10357,0,8,30,90,60,1,8.523442
2010,8907,10357,0,1,-1,80,81,0,6.925222
2010,4898,10391,0,5,-2,78,80,0,-0.643874
2010,6105,10391,0,8,-18,64,82,0,-3.167848
2010,10493,10391,0,9,13,69,56,1,2.525186
2010,2365,10493,0,1,21,78,57,1,6.354738
2010,4289,10493,0,1,-7,66,73,0,1.641674
2010,5407,10493,0,-8,-9,59,68,0,-1.252244
2010,5640,10493,0,-13,-27,50,77,0,-20.398535
2010,10391,10493,0,-9,-13,56,69,0,-2.525186
2010,401,10655,0,0,17,61,44,1,-1.477785
2010,1871,10689,0,-8,18,87,69,1,-12.926953
2010,10712,10689,0,-9,-4,49,53,0,-15.779977
2010,10689,10712,0,9,4,53,49,1,15.779977
2010,4208,10811,0,4,5,101,96,1,4.24806
2010,5305,10811,0,-5,-11,54,65,0,0.580614
2010,7025,10811,0,3,-3,68,71,0,-1.460085
2011,6568,65,0,13,13,69,56,1,16.940607
2011,9757,152,0,0,9,70,61,1,7.49628
2011,1805,314,0,2,2,65,63,1,0.851707
2011,2366,314,0,4,-16,77,93,0,8.799751
2011,5103,314,0,-7,-2,75,77,0,-9.344647
2011,8908,314,0,1,-1,69,70,0,5.226703
2011,9560,382,0,0,4,81,77,1,3.646122
2011,10690,667,0,9,14,72,58,1,5.668075
2011,4175,824,0,15,19,72,53,1,27.538406
2011,1805,978,0,11,29,81,52,1,14.141605
2011,1805,1039,0,5,12,53,41,1,6.522745
2011,2805,1039,0,6,-3,71,74,0,5.062961
2011,6758,1039,0,-1,-2,58,60,0,-1.747653
2011,7026,1039,0,7,-1,70,71,0,10.749147
2011,9910,1039,0,-3,-8,62,70,0,-4.944524
2011,10690,1039,0,4,-7,54,61,0,8.306654
2011,2805,1073,0,1,9,83,74,1,-3.242309
2011,3294,1073,0,-8,-22,67,89,0,-4.80066
2011,10713,1073,0,-11,-8,66,74,0,-14.926313
2011,1805,1474,0,3,11,69,58,1,1.592684
2011,5408,1474,0,-5,-15,63,78,0,0.003667
2011,9295,1542,0,0,-18,52,70,0,-4.419233
2011,10494,1542,0,7,8,84,76,1,2.884484
2011,314,1805,0,-2,-2,63,65,0,-0.851707
2011,978,1805,0,-11,-29,52,81,0,-14.141605
2011,1039,1805,0,-5,-12,41,53,0,-6.522745
2011,1474,1805,0,-3,-11,58,69,0,-1.592684
2011,4290,1805,0,-1,-1,55,56,0,3.178408
2011,7719,1805,0,1,-7,67,74,0,1.229114
2011,314,2366,0,-4,16,93,77,1,-8.799751
2011,3356,2366,0,-15,-42,45,87,0,-29.792126
2011,5238,2366,0,-7,-2,71,73,0,-11.965639
2011,1039,2805,0,-6,3,74,71,1,-5.062961
2011,1073,2805,0,-1,-9,74,83,0,3.242309
2011,7820,2805,0,-13,-28,51,79,0,-13.737453
2011,9428,2805,0,-5,-8,65,73,0,-3.708938
2011,6568,2904,0,8,-14,57,71,0,6.221084
2011,8942,2904,0,3,-7,50,57,0,0.3674
2011,9910,2904,0,-1,1,72,71,1,-7.145997
2011,6655,3124,0,7,32,98,66,1,13.641786
2011,10046,3124,0,-1,-4,57,61,0,3.743411
2011,9910,3158,0,-5,18,74,56,1,-9.936086
2011,10392,3192,0,3,3,68,65,1,10.504682
2011,1073,3294,0,8,22,89,67,1,4.80066
2011,8431,3294,0,5,-15,71,86,0,-0.312955
2011,2366,3356,0,15,42,87,45,1,29.792126
2011,4175,3771,0,8,14,73,59,1,8.375572
2011,9655,3771,0,1,-11,62,73,0,-1.33103
2011,8688,3878,0,11,17,77,60,1,16.377765
2011,824,4175,0,-15,-19,53,72,0,-27.538406
2011,3771,4175,0,-8,-14,59,73,0,-8.375572
2011,7383,4175,0,-11,-20,57,77,0,-13.922538
2011,9910,4175,0,-10,10,71,61,1,-19.309987
2011,9825,4209,0,-7,-5,68,73,0,-1.252511
2011,10690,4209,0,1,5,70,65,1,4.058034
2011,1805,4290,0,1,1,56,55,1,-3.178408
2011,6307,4290,0,2,-7,69,76,0,-1.755589
2011,6655,4290,0,3,-2,60,62,0,5.145624
2011,7159,4290,0,-9,-2,57,59,0,-16.870956
2011,10494,4290,0,-1,-8,63,71,0,-3.95934
2011,6307,4540,0,13,15,102,87,1,16.250018
2011,5607,4622,0,-9,1,62,61,1,-16.868927
2011,6307,4899,0,9,18,81,63,1,3.463319
2011,8688,4899,0,8,-4,62,66,0,4.098743
2011,10812,4899,0,5,-11,55,66,0,-2.886825
2011,314,5103,0,7,2,77,75,1,9.344647
2011,2366,5238,0,7,2,73,71,1,11.965639
2011,8806,5238,0,-1,-30,45,75,0,-1.380183
2011,9428,5272,0,3,2,78,76,1,-1.832751
2011,1474,5408,0,5,15,78,63,1,-0.003667
2011,4622,5607,0,9,-1,61,62,0,16.868927
2011,7383,5607,0,1,17,65,48,1,8.671923
2011,7719,5789,0,13,18,68,50,1,16.759985
2011,4290,6307,0,-2,7,76,69,1,1.755589
2011,4540,6307,0,-13,-15,87,102,0,-16.250018
2011,4899,6307,0,-9,-18,63,81,0,-3.463319
2011,10392,6307,0,-5,-3,83,86,0,2.209336
2011,65,6568,0,-13,-13,56,69,0,-16.940607
2011,2904,6568,0,-8,14,71,57,1,-6.221084
2011,8908,6587,0,9,4,85,81,1,13.434546
2011,3124,6655,0,-7,-32,66,98,0,-13.641786
2011,4290,6655,0,-3,2,62,60,1,-5.145624
2011,9757,6655,0,-15,-29,46,75,0,-31.294858
2011,1039,6758,0,1,2,60,58,1,1.747653
2011,8772,6958,0,3,2,66,64,1,0.57699
2011,1039,7026,0,-7,1,71,70,1,-10.749147
2011,9560,7026,0,-15,-23,51,74,0,-21.910413
2011,4290,7159,0,9,2,59,57,1,16.870956
2011,8567,7227,0,-11,-22,43,65,0,-20.037839
2011,9910,7227,0,-8,18,94,76,1,-14.384674
2011,4175,7383,0,11,20,77,57,1,13.922538
2011,5607,7383,0,-1,-17,48,65,0,-8.671923
2011,9978,7383,0,7,-3,66,69,0,4.264324
2011,1805,7719,0,-1,7,74,67,1,-1.229114
2011,5789,7719,0,-13,-18,50,68,0,-16.759985
2011,8772,7719,0,-5,-7,64,71,0,-5.801854
2011,2805,7820,0,13,28,79,51,1,13.737453
2011,3294,8431,0,-5,15,86,71,1,0.312955
2011,7227,8567,0,11,22,65,43,1,20.037839
2011,3878,8688,0,-11,-17,60,77,0,-16.377765
2011,4899,8688,0,-8,4,66,62,1,-4.098743
2011,6958,8772,0,-3,-2,64,66,0,-0.57699
2011,7719,8772,0,5,7,71,64,1,5.801854
2011,5238,8806,0,1,30,75,45,1,1.380183
2011,314,8908,0,-1,1,70,69,1,-5.226703
2011,6587,8908,0,-9,-4,81,85,0,-13.434546
2011,2904,8942,0,-3,7,57,50,1,-0.3674
2011,1542,9295,0,0,18,70,52,1,4.419233
2011,2805,9428,0,5,8,73,65,1,3.708938
2011,5272,9428,0,-3,-2,76,78,0,1.832751
2011,382,9560,0,0,-4,77,81,0,-3.646122
2011,7026,9560,0,15,23,74,51,1,21.910413
2011,3771,9655,0,-1,11,73,62,1,1.33103
2011,9910,9689,0,0,13,59,46,1,-6.680398
2011,152,9757,0,0,-9,61,70,0,-7.49628
2011,6655,9757,0,15,29,75,46,1,31.294858
2011,4209,9825,0,7,5,73,68,1,1.252511
2011,1039,9910,0,3,8,70,62,1,4.944524
2011,2904,9910,0,1,-1,71,72,0,7.145997
2011,3158,9910,0,5,-18,56,74,0,9.936086
2011,4175,9910,0,10,-10,61,71,0,19.309987
2011,7227,9910,0,8,-18,76,94,0,14.384674
2011,9689,9910,0,0,-13,46,59,0,6.680398
2011,7383,9978,0,-7,3,69,66,1,-4.264324
2011,3124,10046,0,1,4,61,57,1,-3.743411
2011,3192,10392,0,-3,-3,65,68,0,-10.504682
2011,6307,10392,0,5,3,86,83,1,-2.209336
2011,1542,10494,0,-7,-8,76,84,0,-2.884484
2011,4290,10494,0,1,8,71,63,1,3.95934
2011,667,10690,0,-9,-14,58,72,0,-5.668075
2011,1039,10690,0,-4,7,61,54,1,-8.306654
2011,4209,10690,0,-1,-5,65,70,0,-4.058034
2011,1073,10713,0,11,8,74,66,1,14.926313
2011,4899,10812,0,-5,11,66,55,1,2.886825
2012,1907,100,0,1,1,58,57,1,-0.444675
2012,1704,649,0,-8,-17,63,80,0,-9.326795
2012,4291,649,0,2,12,82,70,1,7.666936
2012,7533,649,0,-11,-8,60,68,0,-9.608693
2012,10813,649,0,-7,-5,70,75,0,-7.743045
2012,3159,668,0,11,15,74,59,1,4.619606
2012,3913,1074,0,0,-6,72,78,0,-3.143426
2012,4900,1074,0,11,20,88,68,1,5.209193
2012,8198,1166,0,0,11,65,54,1,-5.445499
2012,2905,1475,0,3,-6,56,62,0,2.565322
2012,6656,1475,0,4,15,81,66,1,11.754355
2012,8909,1475,0,-5,-6,59,65,0,1.881212
2012,649,1704,0,8,17,80,63,1,9.326795
2012,9656,1704,0,5,-4,64,68,0,6.683261
2012,5776,1738,0,5,17,58,41,1,1.079116
2012,3981,1806,0,1,13,77,64,1,0.732322
2012,100,1907,0,-1,-1,57,58,0,0.444675
2012,6308,1907,0,7,14,87,73,1,8.602444
2012,4623,2075,0,9,7,69,62,1,8.169491
2012,4176,2265,0,13,15,65,50,1,19.63333
2012,4427,2367,0,-13,5,75,70,1,-13.995694
2012,4623,2806,0,3,4,72,68,1,-1.835798
2012,4900,2806,0,4,-10,58,68,0,-0.622348
2012,6274,2806,0,-8,-34,50,84,0,-21.387443
2012,10081,2806,0,-3,-26,45,71,0,-3.928505
2012,1475,2905,0,-3,6,62,56,1,-2.565322
2012,8330,2905,0,-11,-3,63,66,0,-7.068908
2012,668,3159,0,-11,-15,59,74,0,-4.619606
2012,5956,3159,0,-8,3,66,63,1,-5.160419
2012,6656,3295,0,5,7,73,66,1,11.329089
2012,10495,3295,0,-3,-23,54,77,0,-0.117304
2012,9979,3431,0,7,9,79,70,1,7.592779
2012,4291,3845,0,3,12,102,90,1,5.414003
2012,6141,3845,0,-9,-13,66,79,0,-10.269686
2012,9911,3845,0,-8,-2,61,63,0,-11.031927
2012,1074,3913,0,0,6,78,72,1,3.143426
2012,1806,3981,0,-1,-13,64,77,0,-0.732322
2012,4291,3981,0,7,16,87,71,1,11.13101
2012,2265,4176,0,-13,-15,50,65,0,-19.63333
2012,4291,4176,0,1,8,67,59,1,2.488566
2012,5956,4176,0,-9,-3,57,60,0,-10.484278
2012,6308,4176,0,1,-13,67,80,0,-0.021295
2012,6656,4176,0,0,-2,62,64,0,2.301101
2012,7228,4176,0,-8,-3,60,63,0,-8.055171
2012,8232,4210,0,-1,-6,64,70,0,-7.050385
2012,8689,4210,0,7,16,75,59,1,6.140414
2012,649,4291,0,-2,-12,70,82,0,-7.666936
2012,3845,4291,0,-3,-12,90,102,0,-5.414003
2012,3981,4291,0,-7,-16,71,87,0,-11.13101
2012,4176,4291,0,-1,-8,59,67,0,-2.488566
2012,4623,4291,0,-3,-8,61,69,0,-9.094484
2012,10251,4291,0,-15,-15,66,81,0,-27.423748
2012,10013,4393,0,0,12,71,59,1,-2.616505
2012,2367,4427,0,13,-5,70,75,0,13.995694
2012,10813,4427,0,5,12,70,58,1,5.242484
2012,6107,4507,0,7,7,75,68,1,6.218288
2012,5273,4541,0,15,22,89,67,1,23.710037
2012,2075,4623,0,-9,-7,62,69,0,-8.169491
2012,2806,4623,0,-3,-4,68,72,0,1.835798
2012,4291,4623,0,3,8,69,61,1,9.094484
2012,5273,4623,0,3,-13,44,57,0,6.796161
2012,6107,4623,0,-1,-3,56,59,0,0.472277
2012,6656,4691,0,13,19,78,59,1,24.291122
2012,1074,4900,0,-11,-20,68,88,0,-5.209193
2012,2806,4900,0,-4,10,68,58,1,0.622348
2012,5776,4900,0,-3,-9,53,62,0,-8.221777
2012,8500,5104,0,-1,7,61,54,1,-2.582441
2012,6622,5239,0,-9,5,65,60,1,-7.329463
2012,4541,5273,0,-15,-22,67,89,0,-23.710037
2012,4623,5273,0,-3,13,57,44,1,-6.796161
2012,8500,5273,0,-8,-4,61,65,0,-7.485494
2012,6274,5409,0,-13,2,86,84,1,-24.81774
2012,10691,5540,0,9,24,73,49,1,14.076008
2012,10251,5678,0,0,1,59,58,1,5.160341
2012,1738,5776,0,-5,-17,41,58,0,-1.079116
2012,4900,5776,0,3,9,62,53,1,8.221777
2012,3159,5956,0,8,-3,63,66,0,5.160419
2012,4176,5956,0,9,3,60,57,1,10.484278
2012,7720,5956,0,5,-14,65,79,0,-1.811244
2012,4507,6107,0,-7,-7,68,75,0,-6.218288
2012,4623,6107,0,1,3,59,56,1,-0.472277
2012,3845,6141,0,9,13,79,66,1,10.269686
2012,2806,6274,0,8,34,84,50,1,21.387443
2012,5409,6274,0,13,-2,84,86,0,24.81774
2012,1907,6308,0,-7,-14,73,87,0,-8.602444
2012,4176,6308,0,-1,13,80,67,1,0.021295
2012,6622,6308,0,-12,-8,65,73,0,-15.517068
2012,10013,6308,0,-15,-19,58,77,0,-21.620129
2012,10813,6569,0,-3,4,67,63,1,-2.202399
2012,5239,6622,0,9,-5,60,65,0,7.329463
2012,6308,6622,0,12,8,73,65,1,15.517068
2012,8198,6622,0,1,-6,56,62,0,1.944727
2012,1475,6656,0,-4,-15,66,81,0,-11.754355
2012,3295,6656,0,-5,-7,66,73,0,-11.329089
2012,4176,6656,0,0,2,64,62,1,-2.301101
2012,4691,6656,0,-13,-19,59,78,0,-24.291122
2012,8689,6656,0,1,-7,70,77,0,-3.133631
2012,4176,7228,0,8,3,63,60,1,8.055171
2012,8534,7228,0,3,-3,69,72,0,-2.772973
2012,649,7533,0,11,8,68,60,1,9.608693
2012,5956,7720,0,-5,14,79,65,1,1.811244
2012,1166,8198,0,0,-11,54,65,0,5.445499
2012,6622,8198,0,-1,6,62,56,1,-1.944727
2012,8773,8198,0,7,-14,44,58,0,2.57774
2012,4210,8232,0,1,6,70,64,1,7.050385
2012,2905,8330,0,11,3,66,63,1,7.068908
2012,5104,8500,0,1,-7,54,61,0,2.582441
2012,5273,8500,0,8,4,65,61,1,7.485494
2012,7228,8534,0,-3,3,72,69,1,2.772973
2012,4210,8689,0,-7,-16,59,75,0,-6.140414
2012,6656,8689,0,-1,7,77,70,1,3.133631
2012,9561,8689,0,-15,-7,65,72,0,-18.571142
2012,10691,8689,0,-3,-1,63,64,0,-2.164004
2012,8198,8773,0,-7,14,58,44,1,-2.57774
2012,1475,8909,0,5,6,65,59,1,-1.881212
2012,8689,9561,0,15,7,72,65,1,18.571142
2012,1704,9656,0,-5,4,68,64,1,-6.683261
2012,3845,9911,0,8,2,63,61,1,11.031927
2012,10591,9911,0,7,-3,59,62,0,10.007484
2012,3431,9979,0,-7,-9,70,79,0,-7.592779
2012,10691,9979,0,1,3,60,57,1,3.512267
2012,4393,10013,0,0,-12,59,71,0,2.616505
2012,6308,10013,0,15,19,77,58,1,21.620129
2012,2806,10081,0,3,26,71,45,1,3.928505
2012,4291,10251,0,15,15,81,66,1,27.423748
2012,5678,10251,0,0,-1,58,59,0,-5.160341
2012,3295,10495,0,3,23,77,54,1,0.117304
2012,9911,10591,0,-7,3,62,59,1,-10.007484
2012,5540,10691,0,-9,-24,49,73,0,-14.076008
2012,8689,10691,0,3,1,64,63,1,2.164004
2012,9979,10691,0,-1,-3,57,60,0,-3.512267
2012,649,10813,0,7,5,75,70,1,7.743045
2012,4427,10813,0,-5,-12,58,70,0,-5.242484
2012,6569,10813,0,3,-4,63,67,0,2.202399
2013,9912,67,0,7,46,88,42,1,6.774732
2013,2368,173,0,13,12,73,61,1,22.954004
2013,669,316,0,-5,-17,64,81,0,-6.02282
2013,3432,316,0,-8,-23,51,74,0,-13.057157
2013,6657,316,0,4,3,73,70,1,3.466752
2013,316,669,0,5,17,81,64,1,6.02282
2013,4326,758,0,0,9,80,71,1,-0.537678
2013,1041,980,0,5,12,68,56,1,3.542577
2013,980,1041,0,-5,-12,56,68,0,-3.542577
2013,4901,1041,0,3,2,74,72,1,3.492119
2013,8690,1167,0,8,6,66,60,1,8.680342
2013,9657,1167,0,7,-3,61,64,0,3.074841
2013,1908,1476,0,3,4,67,63,1,2.079776
2013,3773,1705,0,3,8,57,49,1,0.870956
2013,4624,1739,0,7,26,82,56,1,9.835244
2013,5410,1739,0,-1,-12,72,84,0,1.684134
2013,1476,1908,0,-3,-4,63,67,0,-2.079776
2013,2368,1908,0,5,16,66,50,1,5.081202
2013,4901,2076,0,11,1,59,58,1,7.091489
2013,173,2368,0,-13,-12,61,73,0,-22.954004
2013,1908,2368,0,-5,-16,50,66,0,-5.081202
2013,4624,2368,0,1,22,85,63,1,2.37708
2013,5274,2368,0,-1,-10,61,71,0,-3.294992
2013,2807,2773,0,12,12,62,50,1,23.651956
2013,3160,2773,0,13,-10,68,78,0,15.764547
2013,7721,2773,0,8,-10,71,81,0,12.934429
2013,2773,2807,0,-12,-12,50,62,0,-23.651956
2013,5240,2807,0,-1,20,79,59,1,-4.48313
2013,5308,2807,0,-8,-14,64,78,0,-7.893797
2013,6536,2807,0,-11,-32,47,79,0,-23.780971
2013,2773,3160,0,-13,10,78,68,1,-15.764547
2013,8267,3296,0,-15,-6,58,64,0,-24.573305
2013,10592,3296,0,-8,6,76,70,1,-8.361469
2013,316,3432,0,8,23,74,51,1,13.057157
2013,6108,3432,0,11,-6,62,68,0,10.475151
2013,1705,3773,0,-3,-8,49,57,0,-0.870956
2013,5172,3773,0,5,4,63,59,1,3.931735
2013,4143,3846,0,-15,-21,62,83,0,-28.043264
2013,8690,3846,0,-3,11,61,50,1,-6.549474
2013,8774,3846,0,-8,-6,52,58,0,-16.799165
2013,6657,3914,0,13,25,95,70,1,15.965776
2013,6570,3982,0,3,-18,58,76,0,0.453143
2013,6657,3982,0,8,3,78,75,1,6.502365
2013,3846,4143,0,15,21,83,62,1,28.043264
2013,4542,4143,0,0,-13,55,68,0,-0.595464
2013,5240,4177,0,-3,2,87,85,1,-0.997284
2013,6309,4177,0,-7,-12,58,70,0,-6.304969
2013,10252,4177,0,-15,-7,57,64,0,-22.054938
2013,4326,4211,0,-9,2,63,61,1,-3.839806
2013,758,4326,0,0,-9,71,80,0,0.537678
2013,4211,4326,0,9,-2,61,63,0,3.839806
2013,5342,4326,0,1,-2,74,76,0,4.568891
2013,10592,4326,0,4,14,72,58,1,3.213169
2013,5912,4458,0,0,1,73,72,1,2.092896
2013,4143,4542,0,0,13,68,55,1,0.595464
2013,1739,4624,0,-7,-26,56,82,0,-9.835244
2013,2368,4624,0,-1,-22,63,85,0,-2.37708
2013,5240,4624,0,-3,-6,76,82,0,-4.076005
2013,5912,4624,0,-15,-31,48,79,0,-31.097884
2013,6824,4624,0,-11,-8,69,77,0,-11.174301
2013,10592,4624,0,-8,-4,68,72,0,-11.0953
2013,1041,4901,0,-3,-2,72,74,0,-3.492119
2013,2076,4901,0,-11,-1,58,59,0,-7.091489
2013,5172,4901,0,1,-10,61,71,0,2.702432
2013,8690,4901,0,-1,16,55,39,1,4.920967
2013,5274,5105,0,3,22,70,48,1,6.003248
2013,8535,5105,0,-5,-2,52,54,0,2.118592
2013,3773,5172,0,-5,-4,59,63,0,-3.931735
2013,4901,5172,0,-1,10,71,61,1,-2.702432
2013,6892,5172,0,-13,-29,49,78,0,-13.858889
2013,2807,5240,0,1,-20,59,79,0,4.48313
2013,4177,5240,0,3,-2,85,87,0,0.997284
2013,4624,5240,0,3,6,82,76,1,4.076005
2013,7534,5240,0,-9,-15,56,71,0,-17.620501
2013,8690,5240,0,0,-5,56,61,0,-0.816906
2013,9912,5240,0,-1,-25,53,78,0,-3.718584
2013,2368,5274,0,1,10,71,61,1,3.294992
2013,5105,5274,0,-3,-22,48,70,0,-6.003248
2013,9946,5274,0,-11,-11,54,65,0,-11.211409
2013,2807,5308,0,8,14,78,64,1,7.893797
2013,9430,5308,0,5,-20,63,83,0,-3.069592
2013,4326,5342,0,-1,2,76,74,1,-4.568891
2013,10692,5342,0,7,-11,46,57,0,4.828752
2013,1739,5410,0,1,12,84,72,1,-1.684134
2013,8690,5541,0,9,47,81,34,1,19.741118
2013,8535,5743,0,0,13,67,54,1,2.99646
2013,4458,5912,0,0,-1,72,73,0,-2.092896
2013,4624,5912,0,15,31,79,48,1,31.097884
2013,8774,5957,0,-1,4,76,72,1,-5.702144
2013,3432,6108,0,-11,6,68,62,1,-10.475151
2013,8501,6142,0,9,20,64,44,1,8.801494
2013,4177,6309,0,7,12,70,58,1,6.304969
2013,10048,6309,0,-1,-7,71,78,0,-3.915172
2013,2807,6536,0,11,32,79,47,1,23.780971
2013,3982,6570,0,-3,18,76,58,1,-0.453143
2013,316,6657,0,-4,-3,70,73,0,-3.466752
2013,3914,6657,0,-13,-25,70,95,0,-15.965776
2013,3982,6657,0,-8,-3,75,78,0,-6.502365
2013,10592,6657,0,-7,4,70,66,1,-7.295366
2013,7721,6692,0,3,15,70,55,1,2.021272
2013,6824,6726,0,-7,13,68,55,1,-3.106318
2013,4624,6824,0,11,8,77,69,1,11.174301
2013,6726,6824,0,7,-13,55,68,0,3.106318
2013,8501,6824,0,8,-17,57,74,0,1.604414
2013,5172,6892,0,13,29,78,49,1,13.858889
2013,10592,7028,0,-1,18,73,55,1,-6.454505
2013,5240,7534,0,9,15,71,56,1,17.620501
2013,2773,7721,0,-8,10,81,71,1,-12.934429
2013,6692,7721,0,-3,-15,55,70,0,-2.021272
2013,3296,8267,0,15,6,64,58,1,24.573305
2013,6142,8501,0,-9,-20,44,64,0,-8.801494
2013,6824,8501,0,-8,17,74,57,1,-1.604414
2013,5105,8535,0,5,2,54,52,1,-2.118592
2013,5743,8535,0,0,-13,54,67,0,-2.99646
2013,1167,8690,0,-8,-6,60,66,0,-8.680342
2013,3846,8690,0,3,-11,50,61,0,6.549474
2013,4901,8690,0,1,-16,39,55,0,-4.920967
2013,5240,8690,0,0,5,61,56,1,0.816906
2013,5541,8690,0,-9,-47,34,81,0,-19.741118
2013,3846,8774,0,8,6,58,52,1,16.799165
2013,5957,8774,0,1,-4,72,76,0,5.702144
2013,5308,9430,0,-5,20,83,63,1,3.069592
2013,1167,9657,0,-7,3,64,61,1,-3.074841
2013,67,9912,0,-7,-46,42,88,0,-6.774732
2013,5240,9912,0,1,25,78,53,1,3.718584
2013,5274,9946,0,11,11,65,54,1,11.211409
2013,6309,10048,0,1,7,78,71,1,3.915172
2013,4177,10252,0,15,7,64,57,1,22.054938
2013,3296,10592,0,8,-6,70,76,0,8.361469
2013,4326,10592,0,-4,-14,58,72,0,-3.213169
2013,4624,10592,0,8,4,72,68,1,11.0953
2013,6657,10592,0,7,-4,66,70,0,7.295366
2013,7028,10592,0,1,-18,55,73,0,6.454505
2013,5342,10692,0,-7,11,57,46,1,-4.828752
2014,2808,174,0,15,12,67,55,1,24.488594
2014,5710,174,0,0,-7,64,71,0,-2.251575
2014,10693,249,0,13,40,75,35,1,17.321998
2014,3297,317,0,-7,-23,61,84,0,-8.083696
2014,7722,317,0,-3,-6,64,70,0,-8.943408
2014,10463,317,0,-15,-9,59,68,0,-24.946254
2014,10693,317,0,-1,1,64,63,1,-5.214945
2014,8911,351,0,3,2,87,85,1,-0.757588
2014,1909,651,0,3,-30,55,85,0,4.405356
2014,6007,651,0,-5,-14,60,74,0,-4.637361
2014,10693,651,0,4,17,69,52,1,3.4872
2014,6825,1076,0,3,19,87,68,1,3.496823
2014,9264,1134,0,0,-12,69,81,0,-7.085406
2014,10593,1134,0,15,27,64,37,1,17.32336
2014,3433,1477,0,-7,4,61,57,1,-4.875932
2014,10083,1611,0,15,11,70,59,1,24.301022
2014,7029,1706,0,-1,29,77,48,1,5.398965
2014,2808,1808,0,6,-10,53,63,0,4.796047
2014,3983,1808,0,4,-5,76,81,0,3.160944
2014,4293,1808,0,-1,-6,54,60,0,1.831654
2014,5275,1808,0,3,-6,54,60,0,4.018249
2014,8468,1808,0,-3,-8,81,89,0,-6.784826
2014,10049,1808,0,5,-12,65,77,0,4.119819
2014,651,1909,0,-3,30,85,55,1,-4.405356
2014,9465,1909,0,-11,-10,66,76,0,-16.911359
2014,2808,2111,0,10,10,62,52,1,11.034372
2014,6658,2111,0,5,-1,59,60,0,8.756329
2014,8604,2111,0,1,-10,72,82,0,4.124271
2014,8691,2111,0,8,-2,53,55,0,6.420454
2014,5275,2145,0,9,15,93,78,1,17.164692
2014,5140,2369,0,-11,7,78,71,1,-15.43956
2014,4178,2471,0,13,11,80,69,1,21.35689
2014,174,2808,0,-15,-12,55,67,0,-24.488594
2014,1808,2808,0,-6,10,63,53,1,-4.796047
2014,2111,2808,0,-10,-10,52,62,0,-11.034372
2014,7029,2808,0,-8,-16,45,61,0,-3.427881
2014,9431,2808,0,-3,-11,68,79,0,-1.83825
2014,5106,3043,0,1,5,71,66,1,2.437884
2014,317,3297,0,7,23,84,61,1,8.083696
2014,6727,3297,0,-1,-8,77,85,0,3.770246
2014,1477,3433,0,7,-4,57,61,0,4.875932
2014,5275,3433,0,8,7,80,73,1,9.350329
2014,8809,3949,0,0,13,78,65,1,-3.01259
2014,1808,3983,0,-4,5,81,76,1,-3.160944
2014,5924,3983,0,-11,-18,75,93,0,-15.025319
2014,6310,3983,0,-3,-2,83,85,0,-3.769024
2014,2471,4178,0,-13,-11,69,80,0,-21.35689
2014,8604,4178,0,-8,3,60,57,1,-7.454496
2014,4293,4212,0,1,7,56,49,1,5.160274
2014,1808,4293,0,1,6,60,54,1,-1.831654
2014,4212,4293,0,-1,-7,49,56,0,-5.160274
2014,4625,4293,0,4,-5,69,74,0,7.466512
2014,5241,4293,0,6,-3,72,75,0,1.104757
2014,10593,4293,0,7,-2,76,78,0,-1.254996
2014,10693,4293,0,6,-1,73,74,0,1.110798
2014,4293,4625,0,-4,5,74,69,1,-7.466512
2014,4834,4625,0,-9,-7,64,71,0,-19.708871
2014,8502,4625,0,-1,-15,51,66,0,-13.59016
2014,4625,4834,0,9,7,71,64,1,19.708871
2014,8809,5004,0,-5,19,86,67,1,5.151108
2014,3043,5106,0,-1,-5,66,71,0,-2.437884
2014,10083,5106,0,7,18,78,60,1,5.157482
2014,2369,5140,0,11,-7,71,78,0,15.43956
2014,8809,5140,0,3,20,83,63,1,11.546184
2014,4293,5241,0,-6,3,75,72,1,-1.104757
2014,8809,5241,0,-9,-2,71,73,0,-2.51378
2014,8911,5241,0,-5,-14,65,79,0,-5.672096
2014,10716,5241,0,-13,-17,40,57,0,-23.451003
2014,1808,5275,0,-3,6,60,54,1,-4.018249
2014,2145,5275,0,-9,-15,78,93,0,-17.164692
2014,3433,5275,0,-8,-7,73,80,0,-9.350329
2014,10083,5275,0,3,-2,59,61,0,-1.514327
2014,174,5710,0,0,7,71,64,1,2.251575
2014,6693,5805,0,7,-5,75,80,0,9.103513
2014,7722,5805,0,8,19,63,44,1,8.567014
2014,3983,5924,0,11,18,93,75,1,15.025319
2014,8502,5958,0,7,3,83,80,1,3.074711
2014,10815,5958,0,0,-15,59,74,0,4.387164
2014,651,6007,0,5,14,74,60,1,4.637361
2014,8604,6109,0,-3,5,58,53,1,0.622441
2014,7722,6143,0,9,4,73,69,1,8.796814
2014,3983,6310,0,3,2,85,83,1,3.769024
2014,7196,6310,0,-5,-2,77,79,0,-3.39559
2014,2111,6658,0,-5,1,60,59,1,-8.756329
2014,5805,6693,0,-7,5,80,75,1,-9.103513
2014,3297,6727,0,1,8,85,77,1,-3.770246
2014,1076,6825,0,-3,-19,68,87,0,-3.496823
2014,10693,6825,0,5,8,85,77,1,2.920438
2014,1706,7029,0,1,-29,48,77,0,-5.398965
2014,2808,7029,0,8,16,61,45,1,3.427881
2014,6310,7196,0,5,2,79,77,1,3.39559
2014,317,7722,0,3,6,70,64,1,8.943408
2014,5805,7722,0,-8,-19,44,63,0,-8.567014
2014,6143,7722,0,-9,-4,69,73,0,-8.796814
2014,9431,8020,0,8,17,77,60,1,14.293473
2014,9913,8020,0,7,-2,75,77,0,10.308973
2014,1808,8468,0,3,8,89,81,1,6.784826
2014,4625,8502,0,1,15,66,51,1,13.59016
2014,5958,8502,0,-7,-3,80,83,0,-3.074711
2014,2111,8604,0,-1,10,82,72,1,-4.124271
2014,4178,8604,0,8,-3,57,60,0,7.454496
2014,6109,8604,0,3,-5,53,58,0,-0.622441
2014,2111,8691,0,-8,2,55,53,1,-6.420454
2014,10287,8691,0,-11,-24,53,77,0,-13.648965
2014,3949,8809,0,0,-13,65,78,0,3.01259
2014,5004,8809,0,5,-19,67,86,0,-5.151108
2014,5140,8809,0,-3,-20,63,83,0,-11.546184
2014,5241,8809,0,9,2,73,71,1,2.51378
2014,351,8911,0,-3,-2,85,87,0,0.757588
2014,5241,8911,0,5,14,79,65,1,5.672096
2014,9431,9196,0,9,17,76,59,1,12.321163
2014,1134,9264,0,0,12,81,69,1,7.085406
2014,2808,9431,0,3,11,79,68,1,1.83825
2014,8020,9431,0,-8,-17,60,77,0,-14.293473
2014,9196,9431,0,-9,-17,59,76,0,-12.321163
2014,1909,9465,0,11,10,76,66,1,16.911359
2014,8020,9913,0,-7,2,77,75,1,-10.308973
2014,1808,10049,0,-5,12,77,65,1,-4.119819
2014,10559,10049,0,-13,-20,53,73,0,-21.383135
2014,1611,10083,0,-15,-11,59,70,0,-24.301022
2014,5106,10083,0,-7,-18,60,78,0,-5.157482
2014,5275,10083,0,-3,2,61,59,1,1.514327
2014,8691,10287,0,11,24,77,53,1,13.648965
2014,317,10463,0,15,9,68,59,1,24.946254
2014,10049,10559,0,13,20,73,53,1,21.383135
2014,1134,10593,0,-15,-27,37,64,0,-17.32336
2014,4293,10593,0,-7,2,78,76,1,1.254996
2014,249,10693,0,-13,-40,35,75,0,-17.321998
2014,317,10693,0,1,-1,63,64,0,5.214945
2014,651,10693,0,-4,-17,52,69,0,-3.4872
2014,4293,10693,0,-6,1,74,73,1,-1.110798
2014,6825,10693,0,-5,-8,77,85,0,-2.920438
2014,5241,10716,0,13,17,57,40,1,23.451003
2014,5958,10815,0,0,15,74,59,1,-4.387164
2015,6694,175,0,11,9,69,60,1,20.354956
2015,6659,318,0,-8,-15,58,73,0,-4.375679
2015,9265,318,0,-13,-21,72,93,0,-30.792046
2015,10694,318,0,1,7,85,78,1,0.192385
2015,10816,318,0,-4,-8,60,68,0,-9.529898
2015,6311,440,0,1,9,87,78,1,6.57375
2015,10717,440,0,-7,-3,53,56,0,-12.359481
2015,3230,652,0,-11,1,57,56,1,-14.043243
2015,10084,671,0,13,12,79,67,1,22.68509
2015,2112,760,0,0,1,56,55,1,0.478195
2015,10498,1009,0,7,6,68,62,1,7.975584
2015,6572,1043,0,3,3,67,64,1,2.717651
2015,8912,1043,0,-5,-8,48,56,0,0.341688
2015,5344,1077,0,0,4,94,90,1,-2.406898
2015,4294,1478,0,7,13,64,51,1,18.80972
2015,7231,1478,0,-1,-1,65,66,0,2.746546
2015,10694,1612,0,15,14,86,72,1,26.451255
2015,3950,2078,0,3,31,83,52,1,2.673649
2015,760,2112,0,0,-1,55,56,0,-0.478195
2015,6694,2112,0,8,6,72,66,1,9.098952
2015,7197,2112,0,5,-13,53,66,0,3.650992
2015,3298,2370,0,-1,-14,52,66,0,-2.244433
2015,5276,2370,0,-6,-20,61,81,0,-6.617234
2015,7455,2370,0,-15,-29,56,85,0,-27.120778
2015,7723,2370,0,-7,-19,49,68,0,-12.122644
2015,9795,2370,0,-4,-6,57,63,0,-2.841996
2015,10694,2370,0,0,-5,63,68,0,0.852651
2015,3162,2540,0,9,10,84,74,1,15.446575
2015,2540,3162,0,-9,-10,74,84,0,-15.446575
2015,9795,3162,0,-1,11,75,64,1,5.243489
2015,5276,3196,0,3,7,70,63,1,4.671689
2015,652,3230,0,11,-1,56,57,0,14.043243
2015,10816,3230,0,8,8,75,67,1,10.312312
2015,2370,3298,0,1,14,66,52,1,2.244433
2015,3950,3298,0,-5,-19,68,87,0,-6.079608
2015,5806,3298,0,-13,-10,76,86,0,-24.079006
2015,9432,3298,0,-9,-12,62,74,0,-9.683944
2015,4294,3360,0,15,23,79,56,1,38.510754
2015,4835,3360,0,0,-10,64,74,0,8.429252
2015,6311,3434,0,9,2,67,65,1,17.11396
2015,10594,3848,0,3,5,81,76,1,1.781954
2015,2078,3950,0,-3,-31,52,83,0,-2.673649
2015,3298,3950,0,5,19,87,68,1,6.079608
2015,9299,3984,0,-11,1,60,59,1,-17.378878
2015,6144,4179,0,-13,-19,56,75,0,-15.677567
2015,10594,4179,0,-5,13,78,65,1,-4.395652
2015,1478,4294,0,-7,-13,51,64,0,-18.80972
2015,3360,4294,0,-15,-23,56,79,0,-38.510754
2015,6572,4294,0,-2,-2,66,68,0,-10.027038
2015,10498,4294,0,-4,-39,39,78,0,-13.057806
2015,10694,4294,0,0,7,71,64,1,-4.452004
2015,10050,4362,0,15,41,93,52,1,25.983129
2015,5276,4626,0,-3,6,76,70,1,-1.12345
2015,5959,4626,0,-4,-10,65,75,0,-4.393751
2015,6470,4626,0,-1,-13,53,66,0,-6.249784
2015,9347,4626,0,-9,-2,55,57,0,-15.141989
2015,5959,4762,0,1,1,66,65,1,2.579559
2015,3360,4835,0,0,10,74,64,1,-8.429252
2015,9948,4971,0,-9,-3,62,65,0,-7.751863
2015,10498,4971,0,-1,10,69,59,1,2.309283
2015,2370,5276,0,6,20,81,61,1,6.617234
2015,3196,5276,0,-3,-7,63,70,0,-4.671689
2015,4626,5276,0,3,-6,70,76,0,1.12345
2015,6694,5276,0,4,-4,58,62,0,2.39387
2015,10084,5276,0,5,-6,54,60,0,5.09709
2015,1077,5344,0,0,-4,90,94,0,2.406898
2015,10816,5344,0,5,19,76,57,1,3.389007
2015,3298,5806,0,13,10,86,76,1,24.079006
2015,4626,5959,0,4,10,75,65,1,4.393751
2015,4762,5959,0,-1,-1,65,66,0,-2.579559
2015,10050,5959,0,7,-3,68,71,0,9.065537
2015,4179,6144,0,13,19,75,56,1,15.677567
2015,440,6311,0,-1,-9,78,87,0,-6.57375
2015,3434,6311,0,-9,-2,65,67,0,-17.11396
2015,10694,6311,0,3,7,79,72,1,3.671626
2015,7455,6334,0,0,4,81,77,1,-2.639006
2015,6572,6402,0,11,4,69,65,1,17.43613
2015,4626,6470,0,1,13,66,53,1,6.249784
2015,10782,6470,0,-7,-17,54,71,0,-8.017704
2015,1043,6572,0,-3,-3,64,67,0,-2.717651
2015,4294,6572,0,2,2,68,66,1,10.027038
2015,6402,6572,0,-11,-4,65,69,0,-17.43613
2015,10594,6572,0,-4,-11,70,81,0,-4.25942
2015,318,6659,0,8,15,73,58,1,4.375679
2015,9914,6659,0,3,-3,72,75,0,-7.511363
2015,175,6694,0,-11,-9,60,69,0,-20.354956
2015,2112,6694,0,-8,-6,66,72,0,-9.098952
2015,5276,6694,0,-4,4,62,58,1,-2.39387
2015,6826,6728,0,1,6,79,73,1,-2.640305
2015,6728,6826,0,-1,-6,73,79,0,2.640305
2015,10694,6826,0,7,7,72,65,1,13.642651
2015,2112,7197,0,-5,13,66,53,1,-3.650992
2015,1478,7231,0,1,1,66,65,1,-2.746546
2015,2370,7455,0,15,29,85,56,1,27.120778
2015,6334,7455,0,0,-4,77,81,0,2.639006
2015,2370,7723,0,7,19,68,49,1,12.122644
2015,8435,7723,0,-1,-12,64,76,0,0.47458
2015,9795,8021,0,7,7,57,50,1,12.595617
2015,9432,8089,0,-5,1,60,59,1,-1.02117
2015,7723,8435,0,1,12,76,64,1,-0.47458
2015,1043,8912,0,5,8,56,48,1,-0.341688
2015,318,9265,0,13,21,93,72,1,30.792046
2015,3984,9299,0,11,-1,59,60,0,17.378878
2015,9432,9299,0,3,17,92,75,1,10.42873
2015,4626,9347,0,9,2,57,55,1,15.141989
2015,3298,9432,0,9,12,74,62,1,9.683944
2015,8089,9432,0,5,-1,59,60,0,1.02117
2015,9299,9432,0,-3,-17,75,92,0,-10.42873
2015,2370,9795,0,4,6,63,57,1,2.841996
2015,3162,9795,0,1,-11,64,75,0,-5.243489
2015,8021,9795,0,-7,-7,50,57,0,-12.595617
2015,6659,9914,0,-3,3,75,72,1,7.511363
2015,4971,9948,0,9,3,65,62,1,7.751863
2015,4362,10050,0,-15,-41,52,93,0,-25.983129
2015,5959,10050,0,-7,3,71,68,1,-9.065537
2015,671,10084,0,-13,-12,67,79,0,-22.68509
2015,5276,10084,0,-5,6,60,54,1,-5.09709
2015,1009,10498,0,-7,-6,62,68,0,-7.975584
2015,4294,10498,0,4,39,78,39,1,13.057806
2015,4971,10498,0,1,-10,59,69,0,-2.309283
2015,3848,10594,0,-3,-5,76,81,0,-1.781954
2015,4179,10594,0,5,-13,65,78,0,4.395652
2015,6572,10594,0,4,11,81,70,1,4.25942
2015,318,10694,0,-1,-7,78,85,0,-0.192385
2015,1612,10694,0,-15,-14,72,86,0,-26.451255
2015,2370,10694,0,0,5,68,63,1,-0.852651
2015,4294,10694,0,0,-7,64,71,0,4.452004
2015,6311,10694,0,-3,-7,72,79,0,-3.671626
2015,6826,10694,0,-7,-7,65,72,0,-13.642651
2015,440,10717,0,7,3,56,53,1,12.359481
2015,6470,10782,0,7,17,71,54,1,8.017704
2015,318,10816,0,4,8,68,60,1,9.529898
2015,3230,10816,0,-8,-8,67,75,0,-10.312312
2015,5344,10816,0,-5,-19,57,76,0,-3.389007
2016,10595,319,0,-5,10,65,55,1,-2.872565
2016,3985,387,0,8,17,78,61,1,10.581686
2016,7232,387,0,7,-2,83,85,0,13.990892
2016,4180,585,0,15,26,105,79,1,30.323956
2016,10851,653,0,-7,4,79,75,1,-8.427248
2016,5175,1010,0,11,7,79,72,1,18.04103
2016,9015,1044,0,1,-10,61,71,0,-3.01802
2016,10085,1044,0,8,8,77,69,1,5.835999
2016,3469,1170,0,-9,11,77,66,1,-7.457642
2016,3849,1411,0,7,25,99,74,1,15.897653
2016,8470,1479,0,1,2,78,76,1,-3.662126
2016,1810,1708,0,-1,7,74,67,1,3.525558
2016,1708,1810,0,1,-7,67,74,0,-3.525558
2016,4180,1810,0,8,12,73,61,1,8.279332
2016,6695,1922,0,13,14,82,68,1,18.177857
2016,8693,2113,0,-3,19,70,51,1,1.477075
2016,6827,2371,0,3,14,82,68,1,-1.923572
2016,9626,2371,0,-9,-8,85,93,0,-13.697766
2016,10851,2371,0,-8,-7,64,71,0,-11.442604
2016,2776,2706,0,0,31,96,65,1,8.303291
2016,2706,2776,0,0,-31,65,96,0,-8.303291
2016,6312,2776,0,15,16,83,67,1,24.732106
2016,9796,2977,0,11,11,80,69,1,11.29225
2016,7990,3299,0,5,-16,52,68,0,-1.499185
2016,8693,3299,0,1,3,63,60,1,-2.695112
2016,9796,3299,0,8,-23,59,82,0,0.289129
2016,10085,3361,0,15,36,81,45,1,30.284658
2016,1170,3469,0,9,-11,66,77,0,7.457642
2016,4972,3469,0,8,13,73,60,1,8.482997
2016,6827,3556,0,15,39,91,52,1,28.998562
2016,8270,3556,0,0,-4,55,59,0,3.665113
2016,1411,3849,0,-7,-25,74,99,0,-15.897653
2016,4295,3849,0,1,-6,67,73,0,0.696545
2016,6312,3849,0,4,15,101,86,1,3.227191
2016,3985,3917,0,9,13,94,81,1,13.618365
2016,8777,3951,0,-3,-2,70,72,0,-10.409589
2016,10051,3951,0,5,19,87,68,1,3.598964
2016,387,3985,0,-8,-17,61,78,0,-10.581686
2016,3917,3985,0,-9,-13,81,94,0,-13.618365
2016,10085,3985,0,3,13,84,71,1,4.455449
2016,585,4180,0,-15,-26,79,105,0,-30.323956
2016,1810,4180,0,-8,-12,61,73,0,-8.279332
2016,4972,4180,0,-4,-16,63,79,0,-7.022069
2016,10051,4180,0,-1,5,64,59,1,-2.76851
2016,3849,4295,0,-1,6,73,67,1,-0.696545
2016,8659,4295,0,-9,-28,57,85,0,-16.264253
2016,3469,4972,0,-8,-13,60,73,0,-8.482997
2016,4180,4972,0,4,16,79,63,1,7.022069
2016,7537,4972,0,-7,-5,74,79,0,-11.910729
2016,1010,5175,0,-11,-7,72,79,0,-18.04103
2016,10051,5175,0,1,23,92,69,1,2.325866
2016,10595,5175,0,-8,-8,57,65,0,-2.70359
2016,6573,5243,0,5,7,70,63,1,-0.10299
2016,9198,5243,0,0,-5,62,67,0,-4.286746
2016,5746,5277,0,-13,9,90,81,1,-21.543652
2016,5277,5746,0,13,-9,81,90,0,21.543652
2016,8693,5746,0,5,25,75,50,1,11.309297
2016,2776,6312,0,-15,-16,67,83,0,-24.732106
2016,3849,6312,0,-4,-15,86,101,0,-3.227191
2016,6573,6312,0,-5,-14,74,88,0,-8.783726
2016,7198,6312,0,-8,-19,66,85,0,-11.168649
2016,8693,6312,0,-9,-17,66,83,0,-9.468653
2016,10051,6312,0,-1,3,77,74,1,-1.39341
2016,8913,6471,0,5,-3,72,75,0,7.534823
2016,8947,6471,0,8,4,92,88,1,10.86876
2016,5243,6573,0,-5,-7,63,70,0,0.10299
2016,6312,6573,0,5,14,88,74,1,8.783726
2016,8022,6573,0,-8,-1,75,76,0,-5.80221
2016,10695,6573,0,-1,-5,56,61,0,-0.766697
2016,1922,6695,0,-13,-14,68,82,0,-18.177857
2016,6827,6695,0,1,-12,68,80,0,-2.771854
2016,8947,6695,0,-1,-14,63,77,0,-1.817215
2016,9915,6695,0,-8,-4,81,85,0,-7.175672
2016,10051,6695,0,0,44,95,51,1,0.736998
2016,2371,6827,0,-3,-14,68,82,0,1.923572
2016,3556,6827,0,-15,-39,52,91,0,-28.998562
2016,6695,6827,0,-1,12,80,68,1,2.771854
2016,8470,6827,0,-7,-5,64,69,0,-6.217673
2016,9915,6861,0,-3,8,75,67,1,2.74233
2016,10695,7031,0,3,4,47,43,1,-2.221952
2016,6312,7198,0,8,19,85,66,1,11.168649
2016,9694,7198,0,1,-1,69,70,0,2.15048
2016,387,7232,0,-7,2,85,83,1,-13.990892
2016,4972,7537,0,7,5,79,74,1,11.910729
2016,3299,7990,0,-5,16,68,52,1,1.499185
2016,6573,8022,0,8,1,76,75,1,5.80221
2016,10499,8022,0,11,-14,56,70,0,14.444195
2016,3556,8270,0,0,4,59,55,1,-3.665113
2016,1479,8470,0,-1,-2,76,78,0,3.662126
2016,6827,8470,0,7,5,69,64,1,6.217673
2016,4295,8659,0,9,28,85,57,1,16.264253
2016,2113,8693,0,3,-19,51,70,0,-1.477075
2016,3299,8693,0,-1,-3,60,63,0,2.695112
2016,5746,8693,0,-5,-25,50,75,0,-11.309297
2016,6312,8693,0,9,17,83,66,1,9.468653
2016,10085,8693,0,9,-6,62,68,0,8.488472
2016,3951,8777,0,3,2,72,70,1,10.409589
2016,6471,8913,0,-5,3,75,72,1,-7.534823
2016,6471,8947,0,-8,-4,88,92,0,-10.86876
2016,6695,8947,0,1,14,77,63,1,1.817215
2016,10533,8947,0,-11,-27,65,92,0,-17.658436
2016,1044,9015,0,-1,10,71,61,1,3.01802
2016,5243,9198,0,0,5,67,62,1,4.286746
2016,10051,9565,0,13,30,86,56,1,20.005284
2016,2371,9626,0,9,8,93,85,1,13.697766
2016,7198,9694,0,-1,1,70,69,1,-2.15048
2016,2977,9796,0,-11,-11,69,80,0,-11.29225
2016,3299,9796,0,-8,23,82,59,1,-0.289129
2016,6695,9915,0,8,4,85,81,1,7.175672
2016,6861,9915,0,3,-8,67,75,0,-2.74233
2016,10595,9983,0,0,20,70,50,1,-1.636707
2016,3951,10051,0,-5,-19,68,87,0,-3.598964
2016,4180,10051,0,1,-5,59,64,0,2.76851
2016,5175,10051,0,-1,-23,69,92,0,-2.325866
2016,6312,10051,0,1,-3,74,77,0,1.39341
2016,6695,10051,0,0,-44,51,95,0,-0.736998
2016,9565,10051,0,-13,-30,56,86,0,-20.005284
2016,1044,10085,0,-8,-8,69,77,0,-5.835999
2016,3361,10085,0,-15,-36,45,81,0,-30.284658
2016,3985,10085,0,-3,-13,71,84,0,-4.455449
2016,8693,10085,0,-9,6,68,62,1,-8.488472
2016,10817,10465,0,13,18,71,53,1,18.43268
2016,8022,10499,0,-11,14,70,56,1,-14.444195
2016,8947,10533,0,11,27,92,65,1,17.658436
2016,319,10595,0,5,-10,55,65,0,2.872565
2016,5175,10595,0,8,8,65,57,1,2.70359
2016,9983,10595,0,0,-20,50,70,0,1.636707
2016,6573,10695,0,1,5,61,56,1,0.766697
2016,7031,10695,0,-3,-4,43,47,0,2.221952
2016,10817,10695,0,5,-3,63,66,0,5.246582
2016,10465,10817,0,-13,-18,53,71,0,-18.43268
2016,10695,10817,0,-5,3,66,63,1,-5.246582
2016,653,10851,0,7,-4,75,79,0,8.427248
2016,2371,10851,0,8,7,71,64,1,11.442604
2017,6323,320,0,-13,-18,82,100,0,-20.265354
2017,8539,320,0,-5,-9,60,69,0,-1.260186
2017,10818,320,0,-9,2,73,71,1,-3.959683
2017,6313,442,0,7,7,72,65,1,11.203971
2017,7991,442,0,-1,-6,71,77,0,-1.289168
2017,6146,654,0,-11,-18,73,91,0,-16.009051
2017,8159,654,0,-4,20,70,50,1,-5.007415
2017,9695,654,0,-8,-4,78,82,0,-9.387281
2017,10500,984,0,9,6,86,80,1,19.213686
2017,5747,1045,0,-8,-9,65,74,0,-8.807612
2017,6313,1045,0,3,12,92,80,1,6.751541
2017,10662,1045,0,-9,-12,64,76,0,-16.985549
2017,4215,1480,0,-5,-14,61,75,0,-3.582586
2017,9434,1480,0,3,12,79,67,1,2.207405
2017,7321,1912,0,-5,12,84,72,1,-5.58794
2017,10596,2114,0,-3,6,64,58,1,8.365356
2017,8159,2372,0,-5,7,88,81,1,-6.916911
2017,9135,2372,0,-13,-22,65,87,0,-22.760139
2017,2811,2639,0,9,15,80,65,1,14.595863
2017,2910,2777,0,11,6,86,80,1,18.57074
2017,2639,2811,0,-9,-15,65,80,0,-14.595863
2017,8159,2811,0,-3,7,77,70,1,-6.674837
2017,10086,2811,0,-1,-26,39,65,0,0.072794
2017,10696,2811,0,-4,-1,83,84,0,-2.821524
2017,2777,2910,0,-11,-6,80,86,0,-18.57074
2017,10818,2910,0,-8,25,91,66,1,-6.244301
2017,6313,3300,0,0,6,71,65,1,-0.663411
2017,6506,3300,0,-7,-6,73,79,0,-11.573356
2017,7538,3300,0,-15,-20,46,66,0,-28.143467
2017,8159,3300,0,-6,-4,73,77,0,-10.215154
2017,10500,3300,0,-3,-3,58,61,0,-0.963663
2017,10818,3300,0,-10,-24,59,83,0,-11.307431
2017,6828,3918,0,11,16,93,77,1,19.671889
2017,6044,3986,0,-7,-11,73,84,0,-10.090218
2017,7233,3986,0,1,4,80,76,1,0.644222
2017,4628,4113,0,13,15,78,63,1,26.777478
2017,5278,4181,0,-8,-20,70,90,0,-9.003686
2017,6828,4181,0,-2,14,74,60,1,-1.951737
2017,7233,4181,0,-3,-32,66,98,0,-1.367571
2017,9315,4181,0,-15,-38,62,100,0,-27.737138
2017,1480,4215,0,5,14,75,61,1,3.582586
2017,10364,4215,0,0,-7,88,95,0,-0.081487
2017,9434,4262,0,11,17,97,80,1,19.793515
2017,5848,4296,0,-13,-9,70,79,0,-24.694737
2017,6313,4296,0,1,2,75,73,1,0.86664
2017,9434,4296,0,-1,-11,75,86,0,-3.370546
2017,10596,4296,0,-8,-3,62,65,0,-2.707829
2017,4113,4628,0,-13,-15,63,78,0,-26.777478
2017,5244,4628,0,-5,4,73,69,1,-4.943854
2017,8159,4905,0,3,20,93,73,1,-0.699345
2017,10818,4973,0,-5,11,76,65,1,1.125914
2017,5278,5176,0,-1,20,78,58,1,-2.06355
2017,4628,5244,0,5,-4,69,73,0,4.943854
2017,6730,5244,0,-3,-1,91,92,0,0.409105
2017,6828,5244,0,4,1,69,68,1,1.968736
2017,4181,5278,0,8,20,90,70,1,9.003686
2017,5176,5278,0,1,-20,58,78,0,2.06355
2017,5747,5312,0,-7,9,81,72,1,-5.714026
2017,6178,5713,0,0,-1,66,67,0,0.324077
2017,10052,5713,0,15,20,76,56,1,29.161287
2017,1045,5747,0,8,9,74,65,1,8.807612
2017,5312,5747,0,7,-9,72,81,0,5.714026
2017,4296,5848,0,13,9,79,70,1,24.694737
2017,9315,5927,0,0,4,67,63,1,-2.375891
2017,3986,6044,0,7,11,84,73,1,10.090218
2017,654,6146,0,11,18,91,73,1,16.009051
2017,5713,6178,0,0,1,67,66,1,-0.324077
2017,442,6313,0,-7,-7,65,72,0,-11.203971
2017,1045,6313,0,-3,-12,80,92,0,-6.751541
2017,3300,6313,0,0,-6,65,71,0,0.663411
2017,4296,6313,0,-1,-2,73,75,0,-0.86664
2017,6828,6313,0,-2,-1,76,77,0,-4.33754
2017,9267,6313,0,-15,-39,64,103,0,-31.051831
2017,320,6323,0,13,18,100,82,1,20.265354
2017,3300,6506,0,7,6,79,73,1,11.573356
2017,9984,6506,0,-1,-2,66,68,0,-0.378473
2017,7165,6574,0,-7,-2,58,60,0,-12.473481
2017,10500,6574,0,1,12,83,71,1,5.883039
2017,5244,6730,0,3,1,92,91,1,-0.409105
2017,3918,6828,0,-11,-16,77,93,0,-19.671889
2017,4181,6828,0,2,-14,60,74,0,1.951737
2017,5244,6828,0,-4,-1,68,69,0,-1.968736
2017,6313,6828,0,2,1,77,76,1,4.33754
2017,7321,6828,0,-8,-3,72,75,0,-8.228736
2017,6574,7165,0,7,2,60,58,1,12.473481
2017,9695,7199,0,0,4,75,71,1,-0.641441
2017,3986,7233,0,-1,-4,76,80,0,-0.644222
2017,4181,7233,0,3,32,98,66,1,1.367571
2017,10018,7233,0,-9,-10,70,80,0,-14.611936
2017,1912,7321,0,5,-12,72,84,0,5.58794
2017,6828,7321,0,8,3,75,72,1,8.228736
2017,3300,7538,0,15,20,66,46,1,28.143467
2017,442,7991,0,1,6,77,71,1,1.289168
2017,9695,8091,0,-5,1,66,65,1,-7.926838
2017,654,8159,0,4,-20,50,70,0,5.007415
2017,2372,8159,0,5,-7,81,88,0,6.916911
2017,2811,8159,0,3,-7,70,77,0,6.674837
2017,3300,8159,0,6,4,77,73,1,10.215154
2017,4905,8159,0,-3,-20,73,93,0,0.699345
2017,320,8539,0,5,9,69,60,1,1.260186
2017,9916,8539,0,-3,-8,77,85,0,-5.234035
2017,2372,9135,0,13,22,87,65,1,22.760139
2017,6313,9267,0,15,39,103,64,1,31.051831
2017,4181,9315,0,15,38,100,62,1,27.737138
2017,5927,9315,0,0,-4,63,67,0,2.375891
2017,1480,9434,0,-3,-12,67,79,0,-2.207405
2017,4262,9434,0,-11,-17,80,97,0,-19.793515
2017,4296,9434,0,1,11,86,75,1,3.370546
2017,10086,9627,0,7,5,76,71,1,14.275967
2017,654,9695,0,8,4,82,78,1,9.387281
2017,7199,9695,0,0,-4,71,75,0,0.641441
2017,8091,9695,0,5,-1,65,66,0,7.926838
2017,8539,9916,0,3,8,85,77,1,5.234035
2017,6506,9984,0,1,2,68,66,1,0.378473
2017,7233,10018,0,9,10,80,70,1,14.611936
2017,5713,10052,0,-15,-20,56,76,0,-29.161287
2017,10696,10052,0,-7,3,65,62,1,-5.367966
2017,2811,10086,0,1,26,65,39,1,-0.072794
2017,9627,10086,0,-7,-5,71,76,0,-14.275967
2017,10696,10120,0,1,10,84,74,1,5.840316
2017,4215,10364,0,0,7,95,88,1,0.081487
2017,984,10500,0,-9,-6,80,86,0,-19.213686
2017,3300,10500,0,3,3,61,58,1,0.963663
2017,6574,10500,0,-1,-12,71,83,0,-5.883039
2017,2114,10596,0,3,-6,58,64,0,-8.365356
2017,4296,10596,0,8,3,65,62,1,2.707829
2017,1045,10662,0,9,12,76,64,1,16.985549
2017,2811,10696,0,4,1,84,83,1,2.821524
2017,10052,10696,0,7,-3,62,65,0,5.367966
2017,10120,10696,0,-1,-10,74,84,0,-5.840316
2017,320,10818,0,9,-2,71,73,0,3.959683
2017,2910,10818,0,8,-25,66,91,0,6.244301
2017,3300,10818,0,10,24,83,59,1,11.307431
2017,4973,10818,0,5,-11,65,76,0,-1.125914
